Rk,Player,Pos,Age,Tm,G,GS,MP,FG,FGA▼,FG%,3P,3PA,3P%,2P,2PA,2P%,eFG%,FT,FTA,FT%,ORB,DRB,TRB,AST,STL,BLK,TOV,PF,PTS
1,Jayson Tatum\tatumja01,SF,23,BOS,21,21,769,181,458,.395,56,177,.316,125,281,.445,.456,92,115,.800,25,154,179,78,20,17,56,55,510
2,Paul George\georgpa01,SF,31,LAC,20,20,711,189,442,.428,58,174,.333,131,268,.489,.493,81,91,.890,9,141,150,104,36,9,83,52,517
3,Trae Young\youngtr01,PG,23,ATL,21,21,709,191,411,.465,56,142,.394,135,269,.502,.533,107,120,.892,12,64,76,190,18,2,80,35,545
4,Zach LaVine\lavinza01,SG,26,CHI,21,21,729,196,405,.484,61,157,.389,135,248,.544,.559,79,91,.868,8,100,108,77,11,7,56,32,532
5,DeMar DeRozan\derozde01,SF,32,CHI,21,21,736,190,393,.483,19,56,.339,171,337,.507,.508,143,159,.899,15,95,110,86,20,8,45,45,542
6,Anthony Davis\davisan02,C,28,LAL,21,21,751,201,389,.517,9,44,.205,192,345,.557,.528,98,134,.731,62,151,213,64,27,48,43,49,509
7,Anthony Edwards\edwaran01,SG,20,MIN,20,20,722,166,385,.431,61,176,.347,105,209,.502,.510,48,64,.750,31,100,131,70,30,14,68,49,441
8,Devin Booker\bookede01,SG,25,PHO,20,20,661,176,384,.458,50,122,.410,126,262,.481,.523,76,89,.854,17,84,101,93,19,5,56,48,478
9,Stephen Curry\curryst01,PG,33,GSW,19,19,650,179,384,.466,105,248,.423,74,136,.544,.603,81,86,.942,10,100,110,130,35,10,62,36,544
10,Donovan Mitchell\mitchdo01,SG,25,UTA,19,19,612,162,381,.425,55,172,.320,107,209,.512,.497,55,63,.873,20,64,84,96,33,4,56,50,434
11,LaMelo Ball\ballla01,PG,20,CHO,22,22,726,157,379,.414,59,156,.378,98,223,.439,.492,54,60,.900,34,139,173,176,41,8,68,68,427
12,Russell Westbrook\westbru01,PG,33,LAL,22,22,798,168,377,.446,30,96,.313,138,281,.491,.485,87,126,.690,31,153,184,191,29,4,104,70,453
13,De'Aaron Fox\foxde01,PG,24,SAC,21,21,728,161,375,.429,24,93,.258,137,282,.486,.461,79,109,.725,13,60,73,117,25,11,62,59,425
14,CJ McCollum\mccolcj01,SG,30,POR,20,20,708,158,369,.428,66,165,.400,92,204,.451,.518,25,36,.694,23,64,87,87,21,14,39,42,407
15,Giannis Antetokounmpo\antetgi01,PF,27,MIL,20,20,648,191,363,.526,23,83,.277,168,280,.600,.558,135,201,.672,36,200,236,117,22,36,61,57,540
16,Miles Bridges\bridgmi02,PF,23,CHO,22,22,797,164,362,.453,49,149,.329,115,213,.540,.521,69,90,.767,32,130,162,72,29,19,39,61,446
17,Kevin Durant\duranke01,PF,33,BRK,19,19,676,198,361,.548,37,90,.411,161,271,.594,.600,111,130,.854,9,136,145,102,14,12,58,24,544
18,Ja Morant\moranja01,PG,22,MEM,19,19,619,170,357,.476,31,87,.356,139,270,.515,.520,87,112,.777,25,81,106,129,30,5,60,25,458
19,Damian Lillard\lillada01,PG,31,POR,19,19,683,142,356,.399,54,178,.303,88,178,.494,.475,80,88,.909,8,65,73,151,13,7,50,28,418
20,Bradley Beal\bealbr01,SG,28,WAS,17,17,611,150,341,.440,30,109,.275,120,232,.517,.484,65,70,.929,14,75,89,100,18,6,67,41,395
21,Reggie Jackson\jacksre01,SG,31,LAC,20,20,671,132,332,.398,58,172,.337,74,160,.463,.485,28,34,.824,12,58,70,76,14,2,40,33,350
22,Tyler Herro\herroty01,SG,22,MIA,18,4,604,149,328,.454,53,133,.398,96,195,.492,.535,41,47,.872,13,90,103,67,10,1,52,24,392
23,Julius Randle\randlju01,PF,27,NYK,20,20,700,135,328,.412,37,112,.330,98,216,.454,.468,77,102,.755,38,165,203,100,13,14,65,54,384
24,Fred VanVleet\vanvlfr01,PG,27,TOR,20,20,763,144,327,.440,64,163,.393,80,164,.488,.538,50,59,.847,17,83,100,130,33,13,63,51,402
25,Luka Dončić\doncilu01,PG,22,DAL,15,15,530,143,325,.440,39,124,.315,104,201,.517,.500,58,85,.682,10,111,121,122,18,10,64,36,383
26,Dejounte Murray\murrade01,PG,25,SAS,18,18,626,145,324,.448,22,70,.314,123,254,.484,.481,29,43,.674,14,137,151,145,38,9,43,36,341
27,Karl-Anthony Towns\townska01,C,26,MIN,20,20,689,164,323,.508,54,121,.446,110,202,.545,.591,79,96,.823,56,125,181,66,24,22,66,70,461
28,Nickeil Alexander-Walker\alexani01,SG,23,NOP,22,18,643,115,311,.370,46,152,.303,69,159,.434,.444,38,48,.792,26,70,96,57,22,10,33,40,314
29,Jonas Valančiūnas\valanjo01,C,29,NOP,22,22,694,155,308,.503,23,50,.460,132,258,.512,.541,73,85,.859,73,198,271,53,11,20,46,70,406
30,Buddy Hield\hieldbu01,SG,29,SAC,21,2,614,122,307,.397,85,225,.378,37,82,.451,.536,34,41,.829,16,77,93,45,14,5,33,44,363
31,D'Angelo Russell\russeda01,PG,25,MIN,18,18,574,122,304,.401,53,155,.342,69,149,.463,.488,50,62,.806,7,58,65,104,16,14,48,38,347
32,Jerami Grant\grantje01,PF,27,DET,19,19,621,124,303,.409,36,108,.333,88,195,.451,.469,91,109,.835,19,72,91,46,23,18,36,42,375
33,Shai Gilgeous-Alexander\gilgesh01,PG,23,OKC,17,17,593,119,295,.403,36,117,.308,83,178,.466,.464,68,85,.800,10,79,89,79,18,8,43,37,342
34,Gary Trent Jr.\trentga02,SG,23,TOR,20,19,688,127,294,.432,53,142,.373,74,152,.487,.522,39,42,.929,11,50,61,33,41,7,19,45,346
35,Jordan Poole\poolejo01,SG,22,GSW,20,20,604,131,292,.449,54,161,.335,77,131,.588,.541,45,49,.918,6,55,61,67,21,4,48,58,361
36,Gordon Hayward\haywago01,SF,31,CHO,22,22,742,133,290,.459,40,99,.404,93,191,.487,.528,68,80,.850,19,89,108,76,19,12,44,39,374
37,Andrew Wiggins\wiggian01,SF,26,GSW,20,20,604,142,286,.497,39,104,.375,103,182,.566,.565,57,78,.731,23,68,91,32,17,11,35,31,380
38,Jordan Clarkson\clarkjo01,SG,29,UTA,20,0,496,107,285,.375,50,177,.282,57,108,.528,.463,36,43,.837,14,47,61,42,14,5,28,30,300
39,Dennis Schröder\schrode01,SG,28,BOS,20,12,666,125,285,.439,29,90,.322,96,195,.492,.489,62,69,.899,16,63,79,98,19,1,56,51,341
40,James Harden\hardeja01,PG,32,BRK,20,20,705,115,283,.406,54,149,.362,61,134,.455,.502,122,136,.897,20,137,157,188,28,16,100,49,406
41,Tyrese Maxey\maxeyty01,PG,21,PHI,20,20,718,139,283,.491,25,65,.385,114,218,.523,.535,67,76,.882,6,65,71,97,16,12,27,49,370
42,Brandon Ingram\ingrabr01,SF,24,NOP,15,15,518,117,282,.415,26,72,.361,91,210,.433,.461,55,64,.859,13,83,96,66,4,6,53,32,315
43,Darius Garland\garlada01,PG,22,CLE,18,18,623,127,280,.454,46,131,.351,81,149,.544,.536,36,43,.837,8,39,47,127,23,1,66,30,336
44,Malcolm Brogdon\brogdma01,PG,29,IND,17,17,595,124,271,.458,35,105,.333,89,166,.536,.522,64,72,.889,17,82,99,101,11,11,42,36,347
45,Kelly Oubre Jr.\oubreke01,SF,26,CHO,22,5,593,119,271,.439,57,154,.370,62,117,.530,.544,29,42,.690,28,61,89,20,18,7,20,55,324
46,RJ Barrett\barrerj01,SF,21,NYK,20,20,648,106,269,.394,34,106,.321,72,163,.442,.457,45,65,.692,11,109,120,44,9,6,35,43,291
47,Saddiq Bey\beysa01,SF,22,DET,20,20,650,97,267,.363,37,126,.294,60,141,.426,.433,30,41,.732,43,86,129,49,21,4,28,35,261
48,Domantas Sabonis\sabondo01,C,25,IND,22,22,738,148,266,.556,17,60,.283,131,206,.636,.588,69,95,.726,69,182,251,83,25,7,67,71,382
49,OG Anunoby\anunoog01,SF,24,TOR,15,15,560,114,265,.430,41,112,.366,73,153,.477,.508,33,40,.825,24,57,81,41,23,9,25,41,302
50,Terry Rozier\roziete01,SG,27,CHO,17,17,551,110,262,.420,42,127,.331,68,135,.504,.500,34,40,.850,12,50,62,56,22,8,25,23,296
51,Ricky Rubio\rubiori01,PG,31,CLE,20,5,588,96,262,.366,42,118,.356,54,144,.375,.447,57,66,.864,9,68,77,126,25,3,62,46,291
52,Jimmy Butler\butleji01,SF,32,MIA,17,17,582,135,260,.519,6,30,.200,129,230,.561,.531,125,147,.850,27,72,99,90,36,5,33,29,401
53,Christian Wood\woodch01,C,26,HOU,19,19,623,119,258,.461,29,87,.333,90,171,.526,.517,45,80,.563,35,179,214,46,10,18,37,47,312
54,Cole Anthony\anthoco01,PG,21,ORL,16,16,545,107,257,.416,45,123,.366,62,134,.463,.504,55,64,.859,9,99,108,94,18,4,47,41,314
55,Desmond Bane\banede01,SF,23,MEM,20,20,575,120,255,.471,50,130,.385,70,125,.560,.569,22,24,.917,10,68,78,39,16,7,28,51,312
56,Jaren Jackson Jr.\jacksja02,PF,22,MEM,20,20,531,102,255,.400,40,120,.333,62,135,.459,.478,55,63,.873,25,89,114,19,17,39,29,68,299
57,Luguentz Dort\dortlu01,SF,22,OKC,18,18,594,108,250,.432,42,131,.321,66,119,.555,.516,54,63,.857,15,64,79,34,14,4,30,52,312
58,Chris Duarte\duartch01,SG,24,IND,20,15,592,104,249,.418,39,109,.358,65,140,.464,.496,15,22,.682,10,75,85,41,19,3,34,37,262
59,Carmelo Anthony\anthoca01,PF,37,LAL,22,3,640,108,248,.435,61,143,.427,47,105,.448,.558,39,48,.813,15,69,84,19,17,15,18,55,316
60,Bojan Bogdanović\bogdabo02,PF,32,UTA,20,20,599,113,246,.459,48,121,.397,65,125,.520,.557,68,73,.932,16,66,82,37,9,1,33,26,342
61,Jalen Suggs\suggsja01,PG,20,ORL,20,20,553,82,244,.336,25,101,.248,57,143,.399,.387,52,68,.765,15,53,68,70,23,9,65,57,241
62,Nikola Jokić\jokicni01,C,26,DEN,14,14,454,144,243,.593,25,61,.410,119,182,.654,.644,56,75,.747,38,152,190,89,17,13,45,41,369
63,Scottie Barnes\barnesc01,PF,20,TOR,19,19,670,117,241,.485,9,28,.321,108,213,.507,.504,46,63,.730,58,99,157,63,21,11,40,50,289
64,Will Barton\bartowi01,SG,31,DEN,17,17,571,109,241,.452,41,109,.376,68,132,.515,.537,18,27,.667,11,80,91,73,18,8,29,20,277
65,Devonte' Graham\grahade01,PG,26,NOP,19,19,587,91,241,.378,52,149,.349,39,92,.424,.485,38,48,.792,13,34,47,89,22,4,37,29,272
66,Tim Hardaway Jr.\hardati02,SG,29,DAL,18,18,600,92,240,.383,45,132,.341,47,108,.435,.477,31,42,.738,5,65,70,45,17,1,9,40,260
67,Franz Wagner\wagnefr01,SF,20,ORL,21,21,655,102,240,.425,30,83,.361,72,157,.459,.488,33,42,.786,29,61,90,48,21,10,22,52,267
68,John Collins\collijo01,PF,24,ATL,21,21,675,136,239,.569,21,57,.368,115,182,.632,.613,55,70,.786,36,131,167,47,16,27,22,59,348
69,Kyle Kuzma\kuzmaky01,PF,26,WAS,20,20,657,99,235,.421,43,121,.355,56,114,.491,.513,28,45,.622,21,163,184,54,12,13,45,44,269
70,Harrison Barnes\barneha02,PF,29,SAC,19,19,665,110,230,.478,37,93,.398,73,137,.533,.559,104,123,.846,26,110,136,46,19,3,39,27,361
71,Keldon Johnson\johnske04,SF,22,SAS,18,18,562,106,230,.461,20,51,.392,86,179,.480,.504,39,60,.650,20,97,117,37,18,4,26,28,271
72,Lonzo Ball\balllo01,PG,24,CHI,21,21,732,95,229,.415,63,146,.432,32,83,.386,.552,6,8,.750,17,96,113,98,39,15,49,52,259
73,Jalen Green\greenja05,SG,19,HOU,18,18,555,87,228,.382,32,115,.278,55,113,.487,.452,46,57,.807,7,49,56,42,11,4,49,28,252
74,Evan Fournier\fournev01,SG,29,NYK,20,20,574,94,227,.414,51,129,.395,43,98,.439,.526,23,30,.767,11,49,60,35,18,4,26,31,262
75,Bam Adebayo\adebaba01,C,24,MIA,17,17,557,115,224,.513,0,1,.000,115,223,.516,.513,83,108,.769,43,127,170,51,20,6,48,54,313
76,LeBron James\jamesle01,SF,37,LAL,11,11,406,106,219,.484,32,93,.344,74,126,.587,.557,40,53,.755,5,52,57,75,20,8,41,25,284
77,Grayson Allen\allengr01,SG,26,MIL,21,21,604,98,218,.450,67,158,.424,31,60,.517,.603,28,31,.903,11,69,80,30,13,6,13,34,291
78,Chris Paul\paulch01,PG,36,PHO,20,20,638,101,214,.472,22,63,.349,79,151,.523,.523,66,78,.846,6,76,82,202,39,6,46,38,290
79,Duncan Robinson\robindu01,SG,27,MIA,20,20,577,79,213,.371,62,183,.339,17,30,.567,.516,5,8,.625,8,69,77,28,17,6,17,64,225
80,Cade Cunningham\cunnica01,PG,20,DET,15,15,469,71,212,.335,27,110,.245,44,102,.431,.399,26,30,.867,16,82,98,72,19,7,52,36,195
81,Josh Giddey\giddejo01,SG,19,OKC,19,19,562,85,211,.403,18,65,.277,67,146,.459,.445,17,26,.654,31,107,138,109,19,11,53,33,205
82,Malik Beasley\beaslma01,SG,25,MIN,20,0,508,73,210,.348,51,155,.329,22,55,.400,.469,11,16,.688,8,46,54,30,14,3,12,20,208
83,Spencer Dinwiddie\dinwisp01,PG,28,WAS,17,17,504,85,210,.405,35,97,.361,50,113,.442,.488,44,48,.917,11,75,86,92,5,3,29,34,249
84,Norman Powell\powelno01,SF,28,POR,18,18,524,106,210,.505,36,81,.444,70,129,.543,.590,56,69,.812,7,38,45,28,17,7,18,35,304
85,Wendell Carter Jr.\cartewe01,C,22,ORL,21,21,593,108,209,.517,32,82,.390,76,127,.598,.593,31,46,.674,44,155,199,48,15,14,29,53,279
86,Jrue Holiday\holidjr01,PG,31,MIL,15,14,458,90,209,.431,25,78,.321,65,131,.496,.490,17,25,.680,10,59,69,88,21,6,38,27,222
87,Jaylen Brown\brownja02,SF,25,BOS,12,12,393,98,207,.473,30,81,.370,68,126,.540,.546,43,55,.782,6,58,64,26,14,6,30,34,269
88,Monte Morris\morrimo01,PG,26,DEN,19,19,562,94,206,.456,24,73,.329,70,133,.526,.515,5,8,.625,6,43,49,80,15,2,26,33,217
89,Kristaps Porziņģis\porzikr01,PF,26,DAL,13,13,400,94,206,.456,24,73,.329,70,133,.526,.515,54,61,.885,33,72,105,26,13,19,20,32,266
90,Seth Curry\curryse01,SG,31,PHI,18,18,611,101,204,.495,40,98,.408,61,106,.575,.593,42,46,.913,9,46,55,44,14,2,31,41,284
91,Jalen Brunson\brunsja01,PG,25,DAL,17,5,496,100,203,.493,19,56,.339,81,147,.551,.539,37,46,.804,8,67,75,90,15,1,27,31,256
92,Davion Mitchell\mitchda01,PG,23,SAC,21,0,534,76,202,.376,22,82,.268,54,120,.450,.431,14,23,.609,16,41,57,74,15,5,20,50,188
93,Cam Reddish\reddica01,SF,22,ATL,21,0,472,83,201,.413,34,89,.382,49,112,.438,.498,41,46,.891,18,41,59,19,23,4,28,30,241
94,Kevin Porter Jr.\porteke02,PG,21,HOU,16,16,509,74,200,.370,29,91,.319,45,109,.413,.443,38,61,.623,15,57,72,92,20,6,69,39,215
95,Marcus Smart\smartma01,PG,27,BOS,20,20,698,78,200,.390,29,101,.287,49,99,.495,.463,38,50,.760,11,70,81,113,42,7,37,45,223
96,Bogdan Bogdanović\bogdabo01,SG,29,ATL,20,20,564,89,199,.447,43,110,.391,46,89,.517,.555,11,14,.786,7,64,71,49,13,4,18,38,232
97,Tobias Harris\harrito02,PF,29,PHI,12,12,410,97,198,.490,16,49,.327,81,149,.544,.530,34,41,.829,14,86,100,49,4,6,22,17,244
98,Tyrese Haliburton\halibty01,SG,21,SAC,19,19,625,87,197,.442,29,77,.377,58,120,.483,.515,20,26,.769,20,52,72,98,35,15,34,24,223
99,Caris LeVert\leverca01,SG,27,IND,14,14,364,85,197,.431,18,63,.286,67,134,.500,.477,20,28,.714,4,37,41,40,10,7,22,30,208
100,Derrick White\whitede01,SG,27,SAS,18,18,561,76,197,.386,25,87,.287,51,110,.464,.449,29,35,.829,9,51,60,93,22,18,28,42,206
101,Aaron Gordon\gordoaa01,PF,26,DEN,19,19,598,101,196,.515,18,52,.346,83,144,.576,.561,38,50,.760,39,78,117,41,11,16,29,40,258
102,Bobby Portis\portibo01,C,26,MIL,16,12,446,96,196,.490,32,72,.444,64,124,.516,.571,22,28,.786,41,93,134,22,11,15,25,40,246
103,Nikola Vučević\vucevni01,C,31,CHI,14,14,460,78,195,.400,15,57,.263,63,138,.457,.438,16,26,.615,25,129,154,57,16,14,23,33,187
104,LaMarcus Aldridge\aldrila01,C,36,BRK,19,2,420,112,193,.580,9,24,.375,103,169,.609,.604,30,38,.789,29,84,113,16,6,21,13,30,263
105,Mikal Bridges\bridgmi01,SF,25,PHO,20,20,683,105,193,.544,27,69,.391,78,124,.629,.614,21,25,.840,15,64,79,37,27,12,14,46,258
106,Clint Capela\capelca01,C,27,ATL,21,21,622,114,192,.594,0,1,.000,114,191,.597,.594,26,50,.520,82,184,266,25,21,30,12,53,254
107,Montrezl Harrell\harremo01,C,28,WAS,20,3,546,124,191,.649,2,7,.286,122,184,.663,.654,83,107,.776,55,114,169,42,11,14,24,39,333
108,Justin Holiday\holidju01,SF,32,IND,22,14,609,76,191,.398,52,146,.356,24,45,.533,.534,8,11,.727,6,55,61,36,11,6,21,47,212
109,Myles Turner\turnemy01,C,25,IND,22,22,626,98,190,.516,39,99,.394,59,91,.648,.618,37,53,.698,35,132,167,23,13,62,31,54,272
110,Mo Bamba\bambamo01,C,23,ORL,20,20,593,85,189,.450,28,83,.337,57,106,.538,.524,17,24,.708,50,131,181,36,18,40,30,55,215
111,Evan Mobley\mobleev01,PF,20,CLE,16,16,540,92,188,.489,10,30,.333,82,158,.519,.516,38,50,.760,28,101,129,40,15,28,28,31,232
112,Darius Bazley\bazleda01,PF,21,OKC,19,19,541,67,187,.358,21,75,.280,46,112,.411,.414,21,36,.583,19,111,130,28,12,22,27,16,176
113,Pat Connaughton\connapa01,SG,29,MIL,21,8,606,93,187,.497,55,133,.414,38,54,.704,.644,14,20,.700,19,89,108,32,20,8,21,32,255
114,Georges Niang\niangge01,PF,28,PHI,20,4,510,81,187,.433,44,112,.393,37,75,.493,.551,22,24,.917,6,50,56,35,13,6,16,57,228
115,Kyle Lowry\lowryky01,PG,35,MIA,18,18,611,78,186,.419,34,111,.306,44,75,.587,.511,31,34,.912,10,80,90,133,22,6,56,50,221
116,Anfernee Simons\simonan01,SG,22,POR,19,1,430,85,186,.457,39,103,.379,46,83,.554,.562,18,19,.947,11,40,51,40,10,2,21,27,227
117,Patty Mills\millspa02,PG,33,BRK,20,6,557,86,185,.465,64,128,.500,22,57,.386,.638,10,11,.909,5,30,35,50,10,4,17,29,246
118,Lonnie Walker\walkelo01,SG,23,SAS,18,3,406,69,185,.373,28,97,.289,41,88,.466,.449,21,26,.808,1,52,53,47,12,7,23,24,187
119,Mike Conley\conlemi01,PG,34,UTA,18,18,510,93,184,.505,47,106,.443,46,78,.590,.633,24,28,.857,4,31,35,95,21,5,31,36,257
120,Khris Middleton\middlkh01,SF,30,MIL,13,13,390,77,183,.421,24,75,.320,53,108,.491,.486,41,48,.854,4,63,67,63,20,2,39,23,219
121,Al Horford\horfoal01,C,35,BOS,18,18,517,82,181,.453,22,76,.289,60,105,.571,.514,39,46,.848,30,120,150,59,14,29,21,41,225
122,Derrick Rose\rosede01,PG,33,NYK,17,1,390,81,180,.450,26,62,.419,55,118,.466,.522,16,17,.941,12,35,47,57,17,11,24,10,204
123,Eric Bledsoe\bledser01,PG,32,LAC,20,20,567,73,179,.408,18,66,.273,55,113,.487,.458,34,40,.850,16,72,88,69,27,11,44,36,198
124,Furkan Korkmaz\korkmfu01,SG,24,PHI,19,5,475,68,179,.380,36,108,.333,32,71,.451,.480,19,24,.792,7,48,55,52,16,3,20,18,191
125,Kemba Walker\walkeke02,PG,31,NYK,18,18,441,76,177,.429,38,92,.413,38,85,.447,.537,20,25,.800,2,44,46,55,19,5,24,19,210
126,Kentavious Caldwell-Pope\caldwke01,SG,28,WAS,20,20,594,74,176,.420,40,107,.374,34,69,.493,.534,27,31,.871,11,65,76,29,27,8,23,32,215
127,Terrence Ross\rosste01,SG,30,ORL,20,0,500,68,176,.386,28,89,.315,40,87,.460,.466,33,42,.786,4,33,37,40,11,3,27,22,197
128,T.J. McConnell\mccontj01,PG,29,IND,22,5,543,88,175,.503,7,24,.292,81,151,.536,.523,10,13,.769,18,60,78,111,23,9,27,42,193
129,Jae'Sean Tate\tateja01,SF,26,HOU,19,19,521,84,174,.483,13,50,.260,71,124,.573,.520,32,43,.744,39,84,123,37,13,10,37,60,213
130,Malik Monk\monkma01,SG,23,LAL,22,2,525,77,171,.450,33,99,.333,44,72,.611,.547,19,23,.826,8,48,56,47,15,6,29,30,206
131,Devin Vassell\vassede01,SF,21,SAS,17,0,439,79,169,.467,33,84,.393,46,85,.541,.565,16,22,.727,9,57,66,25,21,12,13,36,207
132,Luke Kennard\kennalu01,SG,25,LAC,20,0,557,68,168,.405,48,117,.410,20,51,.392,.548,8,8,1.000,4,61,65,40,17,2,16,31,192
133,Kevin Huerter\huertke01,SG,23,ATL,20,10,509,77,167,.461,28,80,.350,49,87,.563,.545,6,8,.750,7,61,68,48,7,4,22,35,188
134,Frank Jackson\jacksfr01,PG,23,DET,20,2,429,67,167,.401,33,107,.308,34,60,.567,.500,28,34,.824,5,22,27,16,11,5,17,28,195
135,Eric Gordon\gordoer01,SG,33,HOU,16,5,468,76,164,.463,35,81,.432,41,83,.494,.570,28,41,.683,3,31,34,39,11,10,33,16,215
136,De'Anthony Melton\meltode01,SG,23,MEM,17,12,430,64,162,.395,32,87,.368,32,75,.427,.494,11,14,.786,12,53,65,40,26,12,25,30,171
137,Joel Embiid\embiijo01,C,27,PHI,10,10,323,72,161,.447,15,37,.405,57,124,.460,.494,76,98,.776,18,82,100,39,9,15,31,24,235
138,Jusuf Nurkić\nurkiju01,C,27,POR,20,20,490,93,160,.581,3,16,.188,90,144,.625,.591,50,66,.758,50,168,218,46,26,11,39,57,239
139,Precious Achiuwa\achiupr01,C,22,TOR,18,14,462,62,158,.392,7,24,.292,55,134,.410,.415,16,29,.552,38,108,146,29,9,10,19,42,147
140,Jae Crowder\crowdja01,PF,31,PHO,20,20,557,59,157,.376,35,107,.327,24,50,.480,.487,20,24,.833,10,83,93,29,26,10,16,46,173
141,Richaun Holmes\holmeri01,C,28,SAC,18,18,493,109,157,.694,2,4,.500,107,153,.699,.701,40,47,.851,50,127,177,21,6,18,29,57,260
142,Deandre Ayton\aytonde01,C,23,PHO,14,14,422,100,156,.641,1,5,.200,99,151,.656,.644,15,25,.600,42,119,161,17,12,8,24,39,216
143,Jarrett Allen\allenja01,C,23,CLE,17,17,564,108,155,.697,1,4,.250,107,151,.709,.700,46,73,.630,59,131,190,31,17,16,34,30,263
144,Alec Burks\burksal01,SG,30,NYK,20,1,446,66,155,.426,41,91,.451,25,64,.391,.558,36,45,.800,6,70,76,36,22,6,15,42,209
145,Shake Milton\miltosh01,PG,25,PHI,15,4,387,70,153,.458,13,45,.289,57,108,.528,.500,27,30,.900,10,39,49,46,8,6,18,30,180
146,Josh Hart\hartjo01,PF,26,NOP,18,17,539,77,151,.510,15,41,.366,62,110,.564,.560,37,44,.841,18,89,107,64,16,7,23,50,206
147,Collin Sexton\sextoco01,SG,23,CLE,11,11,316,68,151,.450,11,45,.244,57,106,.538,.487,29,39,.744,13,23,36,23,10,0,31,25,176
148,Kyle Anderson\anderky01,PF,28,MEM,20,2,435,64,149,.430,18,49,.367,46,100,.460,.490,13,17,.765,21,84,105,50,17,8,20,29,159
149,Terance Mann\mannte01,SF,25,LAC,19,0,540,67,149,.450,21,55,.382,46,94,.489,.520,30,36,.833,26,68,94,45,15,2,23,44,185
150,Cameron Johnson\johnsca02,PF,25,PHO,20,0,441,60,148,.405,36,93,.387,24,55,.436,.527,14,19,.737,6,57,63,23,14,4,12,28,170
151,Immanuel Quickley\quickim01,PG,22,NYK,20,0,382,60,148,.405,34,93,.366,26,55,.473,.520,32,35,.914,7,33,40,50,10,0,19,35,186
152,Cedi Osman\osmande01,SF,26,CLE,17,0,378,69,147,.469,43,100,.430,26,47,.553,.616,17,24,.708,6,43,49,27,12,4,14,28,198
153,Rudy Gobert\goberru01,C,29,UTA,20,20,628,105,145,.724,0,1,.000,105,144,.729,.724,87,131,.664,58,231,289,17,19,44,40,51,297
154,Dorian Finney-Smith\finnedo01,PF,28,DAL,18,18,568,58,141,.411,30,88,.341,28,53,.528,.518,13,21,.619,32,52,84,22,26,9,18,40,159
155,R.J. Hampton\hamptrj01,SG,20,ORL,21,0,402,56,140,.400,23,57,.404,33,83,.398,.482,24,42,.571,8,59,67,50,10,4,30,31,159
156,Lauri Markkanen\markkla01,PF,24,CLE,11,11,345,55,140,.393,23,74,.311,32,66,.485,.475,26,29,.897,16,55,71,13,11,8,10,13,159
157,Pascal Siakam\siakapa01,PF,27,TOR,10,10,332,64,139,.460,13,37,.351,51,102,.500,.507,36,48,.750,20,52,72,36,8,7,19,31,177
158,Jordan Nwora\nworajo01,SF,23,MIL,19,0,364,54,137,.394,25,71,.352,29,66,.439,.485,11,13,.846,10,57,67,23,4,9,24,21,144
159,Jeff Green\greenje02,C,35,DEN,19,10,443,62,136,.456,14,49,.286,48,87,.552,.507,42,52,.808,8,42,50,20,5,8,16,34,180
160,JaVale McGee\mcgeeja01,C,34,PHO,20,6,327,90,136,.662,0,0,,90,136,.662,.662,24,38,.632,46,99,145,13,7,19,32,51,204
161,Cody Martin\martico01,SF,26,CHO,22,0,542,62,130,.477,20,42,.476,42,88,.477,.554,25,35,.714,28,63,91,49,29,11,9,37,169
162,Alex Caruso\carusal01,PG,27,CHI,20,5,594,56,129,.434,20,59,.339,36,70,.514,.512,37,41,.902,17,59,76,81,46,8,27,56,169
163,Cameron Payne\payneca01,PG,27,PHO,15,0,266,49,129,.380,16,55,.291,33,74,.446,.442,31,38,.816,5,33,38,43,10,4,22,25,145
164,George Hill\hillge01,SG,35,MIL,20,11,544,57,126,.452,20,58,.345,37,68,.544,.532,20,21,.952,20,54,74,52,17,3,21,39,154
165,Nassir Little\littlna01,SF,21,POR,20,2,443,62,126,.492,19,59,.322,43,67,.642,.567,24,29,.828,29,77,106,14,16,13,19,43,167
166,Raul Neto\netora01,PG,29,WAS,19,0,381,59,125,.472,8,30,.267,51,95,.537,.504,20,28,.714,1,36,37,48,15,1,27,35,146
167,Joe Harris\harrijo01,SF,30,BRK,14,14,423,56,124,.452,41,88,.466,15,36,.417,.617,5,6,.833,5,51,56,14,7,2,16,31,158
168,Svi Mykhailiuk\mykhasv01,SF,24,TOR,21,3,396,55,124,.444,24,69,.348,31,55,.564,.540,18,20,.900,13,41,54,23,17,2,15,28,152
169,Kira Lewis Jr.\lewiski01,PG,20,NOP,19,0,282,47,123,.382,11,49,.224,36,74,.486,.427,5,7,.714,5,29,34,39,10,0,25,17,110
170,Trey Lyles\lylestr01,PF,26,DET,20,0,328,53,123,.431,18,59,.305,35,64,.547,.504,36,47,.766,28,58,86,16,6,4,20,27,160
171,Jaden McDaniels\mcdanja02,PF,21,MIN,20,11,506,51,123,.415,14,53,.264,37,70,.529,.472,7,11,.636,31,58,89,17,19,12,19,76,123
172,Josh Jackson\jacksjo02,SF,24,DET,18,3,354,50,121,.413,16,56,.286,34,65,.523,.479,23,33,.697,11,53,64,33,7,8,23,32,139
173,Jeremiah Robinson-Earl\robinje02,C,21,OKC,19,12,407,54,119,.454,24,59,.407,30,60,.500,.555,7,11,.636,29,76,105,16,12,7,17,26,139
174,Obi Toppin\toppiob01,PF,23,NYK,20,0,306,63,119,.529,6,33,.182,57,86,.663,.555,31,42,.738,21,51,72,21,6,15,17,31,163
175,Danilo Gallinari\gallida01,PF,33,ATL,18,0,364,45,118,.381,22,61,.361,23,57,.404,.475,30,33,.909,11,54,65,20,10,4,8,20,142
176,Joe Ingles\inglejo01,SF,34,UTA,20,4,494,53,118,.449,38,95,.400,15,23,.652,.610,8,9,.889,10,52,62,61,11,3,20,34,152
177,Naz Reid\reidna01,C,22,MIN,18,0,278,55,117,.470,13,40,.325,42,77,.545,.526,25,34,.735,25,39,64,14,11,19,14,45,148
178,Robert Covington\covinro01,PF,31,POR,20,20,538,49,116,.422,35,92,.380,14,24,.583,.573,3,3,1.000,8,84,92,25,22,21,18,39,136
179,Royce O'Neale\onealro01,SF,28,UTA,19,19,589,53,115,.461,28,79,.354,25,36,.694,.583,10,15,.667,17,73,90,40,32,15,23,44,144
180,Ivica Zubac\zubaciv01,C,24,LAC,20,20,496,74,114,.649,0,0,,74,114,.649,.649,53,70,.757,54,116,170,26,9,17,22,40,201
181,Chris Boucher\bouchch01,PF,29,TOR,19,0,265,43,113,.381,10,50,.200,33,63,.524,.425,16,24,.667,27,51,78,6,11,14,11,25,112
182,Bruce Brown\brownbr01,SF,25,BRK,17,14,413,54,113,.478,7,22,.318,47,91,.516,.509,9,12,.750,16,51,67,19,24,9,13,37,124
183,Andre Drummond\drumman01,C,28,PHI,19,10,426,51,113,.451,0,1,.000,51,112,.455,.451,25,43,.581,62,142,204,42,19,21,35,54,127
184,Josh Richardson\richajo01,SG,28,BOS,15,0,375,53,113,.469,16,47,.340,37,66,.561,.540,20,24,.833,10,35,45,19,9,9,11,29,142
185,Damion Lee\leeda03,SG,29,GSW,15,0,315,49,112,.438,19,54,.352,30,58,.517,.522,17,21,.810,5,38,43,18,3,2,10,20,134
186,Landry Shamet\shamela01,SG,24,PHO,19,0,348,43,112,.384,32,83,.386,11,29,.379,.527,18,22,.818,5,41,46,30,6,2,9,17,136
187,Isaiah Stewart\stewais01,C,20,DET,18,18,433,58,112,.518,1,10,.100,57,102,.559,.522,9,14,.643,39,92,131,19,7,21,20,41,126
188,Dillon Brooks\brookdi01,SF,26,MEM,7,6,172,47,111,.423,12,37,.324,35,74,.473,.477,24,27,.889,6,19,25,16,7,1,11,23,130
189,De'Andre Hunter\huntede01,SF,24,ATL,11,11,306,50,111,.450,15,38,.395,35,73,.479,.518,4,10,.400,4,26,30,7,7,3,14,32,119
190,Kenrich Williams\willike04,SF,27,OKC,19,0,383,50,111,.450,13,39,.333,37,72,.514,.509,16,28,.571,20,47,67,33,13,3,15,33,129
191,Draymond Green\greendr01,PF,31,GSW,19,19,570,61,110,.555,6,19,.316,55,91,.604,.582,27,45,.600,22,126,148,148,22,17,58,51,155
192,Kevin Love\loveke01,PF,33,CLE,12,0,246,41,109,.376,15,54,.278,26,55,.473,.445,27,29,.931,15,79,94,22,2,3,11,15,124
193,Alperen Şengün\sengual01,C,19,HOU,18,2,329,53,109,.486,9,22,.409,44,87,.506,.528,43,65,.662,26,60,86,45,21,10,37,54,158
194,Aleksej Pokusevski\pokusal01,PF,20,OKC,19,0,284,38,108,.352,10,47,.213,28,61,.459,.398,5,8,.625,19,61,80,25,8,7,24,23,91
195,Patrick Beverley\beverpa01,PG,33,MIN,16,12,406,49,107,.458,19,56,.339,30,51,.588,.547,12,17,.706,23,47,70,72,14,16,19,50,129
196,Blake Griffin\griffbl01,PF,32,BRK,17,17,369,34,107,.318,9,56,.161,25,51,.490,.360,16,23,.696,21,63,84,34,9,10,9,39,93
197,Cory Joseph\josepco01,PG,30,DET,20,4,436,47,107,.439,11,37,.297,36,70,.514,.491,30,36,.833,7,28,35,70,17,3,28,31,135
198,Grant Williams\willigr01,PF,23,BOS,21,8,453,55,107,.514,31,72,.431,24,35,.686,.659,19,21,.905,14,60,74,24,6,12,11,37,160
199,Reggie Bullock\bullore01,SF,30,DAL,17,2,390,38,106,.358,21,74,.284,17,32,.531,.458,4,6,.667,4,45,49,12,5,1,8,25,101
200,Aaron Holiday\holidaa01,PG,25,WAS,20,6,355,44,106,.415,12,35,.343,32,71,.451,.472,10,13,.769,4,30,34,38,10,8,25,34,110
201,Kelan Martin\martike03,SF,26,IND,15,1,253,45,106,.425,13,43,.302,32,63,.508,.486,6,9,.667,9,21,30,17,9,6,8,21,109
202,Chuma Okeke\okekech01,PF,23,ORL,15,0,312,40,106,.377,11,49,.224,29,57,.509,.429,18,21,.857,10,50,60,16,10,3,12,20,109
203,Avery Bradley\bradlav01,SG,31,LAL,21,16,467,40,105,.381,22,63,.349,18,42,.429,.486,2,2,1.000,10,43,53,18,13,4,12,30,104
204,Doug McDermott\mcderdo01,PF,30,SAS,12,12,307,47,105,.448,25,57,.439,22,48,.458,.567,6,9,.667,5,22,27,14,2,0,8,15,125
205,Deni Avdija\avdijde01,SF,21,WAS,20,0,437,44,103,.427,15,48,.313,29,55,.527,.500,20,31,.645,16,86,102,26,12,16,13,40,123
206,Talen Horton-Tucker\hortota01,SG,21,LAL,9,6,271,39,103,.379,10,34,.294,29,69,.420,.427,19,20,.950,7,42,49,24,8,5,12,29,107
207,Michael Porter Jr.\portemi01,SF,23,DEN,9,9,265,37,103,.359,10,48,.208,27,55,.491,.408,5,9,.556,9,50,59,17,10,2,12,16,89
208,Daniel Theis\theisda01,C,29,HOU,15,14,350,50,103,.485,14,46,.304,36,57,.632,.553,15,20,.750,16,54,70,11,7,8,19,38,129
209,Torrey Craig\craigto01,SF,31,IND,22,0,379,52,102,.510,14,47,.298,38,55,.691,.578,17,22,.773,30,52,82,21,10,7,14,40,135
210,Gary Harris\harriga01,SG,27,ORL,15,5,355,38,102,.373,9,42,.214,29,60,.483,.417,3,4,.750,13,14,27,25,9,1,15,24,88
211,Ayo Dosunmu\dosunay01,SG,22,CHI,20,0,325,47,101,.465,16,37,.432,31,64,.484,.545,7,11,.636,10,31,41,17,8,3,16,26,117
212,Herb Jones\joneshe01,C,23,NOP,19,10,489,47,101,.465,5,16,.313,42,85,.494,.490,12,16,.750,23,39,62,32,29,12,23,56,111
213,Isaac Okoro\okorois01,SF,21,CLE,13,9,389,36,101,.356,8,41,.195,28,60,.467,.396,18,26,.692,21,38,59,24,12,3,14,31,98
214,Steven Adams\adamsst01,C,28,MEM,20,20,486,49,100,.490,0,0,,49,100,.490,.490,33,48,.688,71,89,160,56,16,16,30,35,131
215,Jakob Poeltl\poeltja01,C,26,SAS,11,10,319,63,100,.630,0,0,,63,100,.630,.630,10,27,.370,50,51,101,23,6,13,16,32,136
216,P.J. Tucker\tuckepj01,PF,36,MIA,20,20,556,52,100,.520,23,50,.460,29,50,.580,.635,9,11,.818,36,81,117,32,10,5,17,51,136
217,PJ Dozier\doziepj01,SG,25,DEN,18,0,340,36,99,.364,15,48,.313,21,51,.412,.439,10,13,.769,14,49,63,29,11,6,13,33,97
218,Mason Plumlee\plumlma01,C,31,CHO,20,20,523,59,99,.596,0,0,,59,99,.596,.596,18,52,.346,51,94,145,55,17,20,24,60,136
219,Nemanja Bjelica\bjeline01,C,33,GSW,20,0,285,45,98,.459,18,48,.375,27,50,.540,.551,17,21,.810,18,59,77,31,15,6,23,23,125
220,Tyus Jones\jonesty01,PG,25,MEM,20,1,322,48,98,.490,18,39,.462,30,59,.508,.582,9,11,.818,3,39,42,66,12,2,11,8,123
221,Kelly Olynyk\olynyke01,C,30,DET,10,1,230,45,98,.459,14,41,.341,31,57,.544,.531,21,35,.600,13,40,53,23,14,7,15,27,125
222,Ziaire Williams\willizi02,SF,20,MEM,18,0,335,35,98,.357,16,65,.246,19,33,.576,.439,4,6,.667,5,23,28,12,8,6,10,33,90
223,Daniel Gafford\gaffoda01,C,23,WAS,17,17,352,64,97,.660,0,0,,64,97,.660,.660,20,30,.667,33,59,92,16,10,35,17,40,148
224,Larry Nance Jr.\nancela02,PF,29,POR,20,0,385,53,97,.546,11,31,.355,42,66,.636,.603,15,23,.652,31,71,102,30,16,9,18,30,132
225,Hassan Whiteside\whiteha01,C,32,UTA,20,0,309,57,97,.588,0,0,,57,97,.588,.588,29,41,.707,42,92,134,4,5,26,21,62,143
226,Nicolas Batum\batumni01,PF,33,LAC,14,13,386,50,96,.521,32,73,.438,18,23,.783,.688,5,10,.500,7,70,77,21,16,11,11,17,137
227,Otto Porter\porteot01,PF,28,GSW,18,0,327,45,96,.469,29,68,.426,16,28,.571,.620,12,16,.750,15,69,84,19,17,7,12,22,131
228,JaMychal Green\greenja01,PF,31,DEN,19,4,284,41,95,.432,9,42,.214,32,53,.604,.479,14,18,.778,20,49,69,16,16,7,25,45,105
229,Bones Hyland\hylanbo01,PG,21,DEN,14,0,216,34,95,.358,20,63,.317,14,32,.438,.463,13,14,.929,4,24,28,23,10,3,11,23,101
230,Garrett Temple\templga01,SG,35,NOP,20,6,371,37,95,.389,20,55,.364,17,40,.425,.495,17,22,.773,13,38,51,23,17,11,19,32,111
231,Lou Williams\willilo02,PG,35,ATL,16,0,206,36,95,.379,9,26,.346,27,69,.391,.426,15,17,.882,5,19,24,25,8,2,12,15,96
232,Killian Hayes\hayeski01,PG,20,DET,15,15,376,30,93,.323,14,38,.368,16,55,.291,.398,11,12,.917,11,41,52,57,22,5,26,40,85
233,Trey Murphy III\murphtr02,SF,21,NOP,21,0,326,33,93,.355,26,69,.377,7,24,.292,.495,9,10,.900,14,37,51,12,7,4,10,24,101
234,Ty Jerome\jeromty01,SG,24,OKC,16,0,211,35,92,.380,18,57,.316,17,35,.486,.478,18,22,.818,6,15,21,19,12,2,4,21,106
235,Kenyon Martin Jr.\martike04,SF,21,HOU,18,0,274,50,92,.543,7,24,.292,43,68,.632,.582,14,21,.667,10,42,52,15,8,9,8,13,121
236,Brandon Clarke\clarkbr01,PF,25,MEM,17,0,273,56,91,.615,0,8,.000,56,83,.675,.615,18,27,.667,30,46,76,23,6,13,6,30,130
237,Isaiah Hartenstein\harteis01,C,23,LAC,19,0,299,59,90,.656,1,2,.500,58,88,.659,.661,20,31,.645,37,60,97,28,17,20,19,48,139
238,Bryn Forbes\forbebr01,SG,28,SAS,18,0,241,39,89,.438,18,47,.383,21,42,.500,.539,6,8,.750,1,18,19,10,6,1,15,13,102
239,Javonte Green\greenja02,SG,28,CHI,21,10,409,44,89,.494,10,25,.400,34,64,.531,.551,18,24,.750,30,58,88,13,18,7,16,42,116
240,Terence Davis\daviste02,SG,24,SAC,13,2,186,28,88,.318,12,53,.226,16,35,.457,.386,7,10,.700,3,22,25,9,7,3,11,25,75
241,Mike Muscala\muscami01,C,30,OKC,15,0,216,39,87,.448,24,55,.436,15,32,.469,.586,23,29,.793,6,42,48,9,6,10,7,20,125
242,Thaddeus Young\youngth01,PF,33,SAS,15,0,238,51,87,.586,0,2,.000,51,85,.600,.586,5,14,.357,24,30,54,44,15,6,18,22,107
243,Jeremy Lamb\lambje01,SF,29,IND,16,0,222,35,86,.407,19,48,.396,16,38,.421,.517,26,26,1.000,2,37,39,18,8,6,8,16,115
244,Jarred Vanderbilt\vandeja01,PF,22,MIN,20,13,435,45,86,.523,0,6,.000,45,80,.563,.523,24,29,.828,59,95,154,23,28,15,23,61,114
245,Moritz Wagner\wagnemo01,C,24,ORL,20,0,220,38,86,.442,22,58,.379,16,28,.571,.570,21,29,.724,10,41,51,13,1,6,15,36,119
246,DeAndre' Bembry\bembrde01,SF,27,BRK,19,4,368,47,84,.560,7,17,.412,40,67,.597,.601,9,17,.529,13,46,59,20,19,8,13,43,110
247,Derrick Favors\favorde01,C,30,OKC,16,8,267,41,84,.488,2,8,.250,39,76,.513,.500,8,14,.571,24,56,80,6,8,2,5,20,92
248,Kevon Looney\looneke01,C,25,GSW,20,20,368,45,83,.542,0,0,,45,83,.542,.542,19,34,.559,49,83,132,22,12,15,13,48,109
249,Chimezie Metu\metuch01,C,24,SAC,10,7,220,29,83,.349,12,47,.255,17,36,.472,.422,10,13,.769,9,57,66,12,7,7,13,13,80
250,Ish Smith\smithis01,PG,33,CHO,16,0,211,32,82,.390,1,2,.500,31,80,.388,.396,3,8,.375,1,17,18,36,7,4,15,10,68
251,Khem Birch\birchkh01,C,29,TOR,15,3,344,40,80,.500,0,6,.000,40,74,.541,.500,24,33,.727,48,37,85,20,15,7,9,27,104
252,Robert Williams\williro04,C,24,BOS,14,14,423,59,80,.738,0,0,,59,80,.738,.738,14,23,.609,56,79,135,19,13,25,16,20,132
253,Kent Bazemore\bazemke01,SF,32,LAL,16,13,344,26,79,.329,12,42,.286,14,37,.378,.405,10,13,.769,4,30,34,14,16,5,8,42,74
254,Caleb Martin\martica02,SF,26,MIA,17,0,278,34,79,.430,8,30,.267,26,49,.531,.481,11,19,.579,12,35,47,9,16,8,9,23,87
255,Facundo Campazzo\campafa01,PG,30,DEN,18,0,315,32,78,.410,19,53,.358,13,25,.520,.532,15,18,.833,6,26,32,37,17,4,20,33,98
256,Max Strus\strusma01,SF,25,MIA,13,0,262,32,78,.410,20,56,.357,12,22,.545,.538,7,12,.583,3,43,46,9,6,2,7,16,91
257,Gabe Vincent\vincega01,PG,25,MIA,17,1,243,33,77,.429,16,45,.356,17,32,.531,.532,10,12,.833,9,16,25,32,9,0,12,32,92
258,Wayne Ellington\ellinwa01,SG,34,LAL,14,1,278,30,76,.395,27,70,.386,3,6,.500,.572,4,4,1.000,3,20,23,9,3,1,6,11,91
259,Drew Eubanks\eubandr01,C,24,SAS,18,8,282,40,76,.526,0,4,.000,40,72,.556,.526,30,38,.789,24,62,86,28,8,15,23,30,110
260,Danny Green\greenda02,SF,34,PHI,13,10,301,36,76,.474,28,65,.431,8,11,.727,.658,4,4,1.000,9,23,32,15,23,10,13,24,104
261,Dwight Powell\poweldw01,C,30,DAL,18,16,374,44,76,.579,6,15,.400,38,61,.623,.618,22,34,.647,39,50,89,20,10,13,14,45,116
262,Dalano Banton\bantoda01,SF,22,TOR,21,0,270,38,75,.507,5,15,.333,33,60,.550,.540,18,24,.750,10,35,45,30,9,5,23,32,99
263,Jaxson Hayes\hayesja02,C,21,NOP,18,0,225,39,75,.520,4,10,.400,35,65,.538,.547,28,37,.757,24,38,62,5,5,12,11,29,110
264,Romeo Langford\langfro01,SG,22,BOS,17,0,323,29,75,.387,15,35,.429,14,40,.350,.487,8,11,.727,16,38,54,9,7,2,10,24,81
265,Frank Ntilikina\ntilila01,PG,23,DAL,15,0,213,27,75,.360,14,39,.359,13,36,.361,.453,12,12,1.000,3,26,29,22,10,3,10,18,80
266,Jevon Carter\carteje01,PG,26,BRK,20,1,282,21,73,.288,18,57,.316,3,16,.188,.411,3,4,.750,4,29,33,24,8,6,7,28,63
267,Austin Rivers\riverau01,SG,29,DEN,17,3,298,24,73,.329,12,45,.267,12,28,.429,.411,3,6,.500,6,18,24,13,9,2,10,21,63
268,P.J. Washington\washipj01,PF,23,CHO,10,2,213,36,73,.493,16,34,.471,20,39,.513,.603,11,14,.786,12,31,43,17,7,10,14,15,99
269,Hamidou Diallo\diallha01,SG,23,DET,14,1,202,38,72,.528,3,14,.214,35,58,.603,.549,13,14,.929,15,26,41,9,9,7,10,23,92
270,Dean Wade\wadede01,PF,25,CLE,16,11,358,29,72,.403,14,47,.298,15,25,.600,.500,5,6,.833,12,40,52,21,11,1,5,32,77
271,Markieff Morris\morrima02,PF,32,MIA,10,0,187,32,70,.457,8,22,.364,24,48,.500,.514,5,5,1.000,13,15,28,14,3,1,12,22,77
272,Gary Payton II\paytoga02,PG,29,GSW,19,1,267,47,70,.671,9,23,.391,38,47,.809,.736,17,27,.630,20,37,57,15,28,2,8,33,120
273,Taurean Prince\princta02,PF,27,MIN,18,2,263,25,70,.357,13,48,.271,12,22,.545,.450,9,12,.750,9,29,38,15,8,3,10,24,72
274,Derrick Jones Jr.\jonesde02,SF,24,CHI,17,0,290,42,69,.609,4,14,.286,38,55,.691,.638,25,30,.833,22,38,60,9,9,14,7,39,113
275,Jalen McDaniels\mcdanja01,SF,24,CHO,20,0,281,39,69,.565,19,39,.487,20,30,.667,.703,14,23,.609,13,51,64,20,7,4,12,32,111
276,Tristan Thompson\thomptr01,PF,30,SAC,15,0,212,34,67,.507,0,0,,34,67,.507,.507,15,30,.500,36,48,84,10,5,6,10,26,83
277,Frank Kaminsky\kaminfr01,C,28,PHO,9,0,181,36,66,.545,5,15,.333,31,51,.608,.583,18,20,.900,11,30,41,13,8,7,5,14,95
278,Armoni Brooks\brookar01,SG,23,HOU,15,0,152,24,65,.369,20,55,.364,4,10,.400,.523,7,8,.875,3,14,17,6,7,1,3,15,75
279,Maurice Harkless\harklma01,SF,28,SAC,16,14,327,25,65,.385,9,40,.225,16,25,.640,.454,8,11,.727,3,42,45,9,8,8,7,25,67
280,Juan Toscano-Anderson\toscaju01,SF,28,GSW,19,1,295,33,65,.508,8,27,.296,25,38,.658,.569,11,13,.846,8,42,50,40,13,8,17,28,85
281,Dewayne Dedmon\dedmode01,C,32,MIA,20,3,282,37,64,.578,3,4,.750,34,60,.567,.602,26,32,.813,30,67,97,9,7,6,17,42,103
282,Matisse Thybulle\thybuma01,SG,24,PHI,13,5,341,34,64,.531,9,29,.310,25,35,.714,.602,6,6,1.000,8,25,33,15,31,20,13,23,83
283,DeAndre Jordan\jordade01,C,33,LAL,19,15,272,45,63,.714,0,0,,45,63,.714,.714,6,10,.600,34,84,118,8,7,17,16,35,96
284,Corey Kispert\kispeco01,SF,22,WAS,18,0,226,24,61,.393,8,37,.216,16,24,.667,.459,8,11,.727,8,25,33,11,4,3,7,8,64
285,Rajon Rondo\rondora01,PG,35,LAL,13,0,199,18,60,.300,7,24,.292,11,36,.306,.358,0,0,,7,21,28,49,11,3,22,19,43
286,Alex Len\lenal01,C,28,SAC,13,3,221,32,59,.542,5,11,.455,27,48,.563,.585,17,25,.680,12,41,53,14,2,15,14,40,86
287,Mitchell Robinson\robinmi01,C,23,NYK,17,17,433,47,59,.797,0,0,,47,59,.797,.797,22,38,.579,52,81,133,13,7,26,10,47,116
288,Tre Mann\manntr01,PG,20,OKC,11,0,126,24,57,.421,7,20,.350,17,37,.459,.482,4,8,.500,6,9,15,2,5,3,5,16,59
289,Naji Marshall\marshna01,SF,24,NOP,15,0,196,19,57,.333,3,22,.136,16,35,.457,.360,23,27,.852,13,39,52,17,7,3,15,19,64
290,Justin Robinson\robinju01,PG,24,MIL,17,0,198,18,57,.316,10,37,.270,8,20,.400,.404,2,2,1.000,2,11,13,21,8,0,11,17,48
291,Xavier Tillman Sr.\tillmxa01,PF,23,MEM,14,0,178,23,57,.404,2,17,.118,21,40,.525,.421,9,13,.692,14,26,40,17,15,2,7,11,57
292,Dāvis Bertāns\bertada01,PF,29,WAS,10,0,167,14,56,.250,11,46,.239,3,10,.300,.348,12,12,1.000,3,16,19,6,2,0,4,16,51
293,Eric Paschall\pascher01,PF,25,UTA,18,0,228,23,56,.411,9,35,.257,14,21,.667,.491,12,17,.706,13,23,36,14,2,3,10,16,67
294,Tomáš Satoranský\satorto01,SG,30,NOP,17,3,270,18,56,.321,2,12,.167,16,44,.364,.339,8,11,.727,9,24,33,38,6,0,13,24,46
295,Coby White\whiteco01,PG,21,CHI,8,1,136,20,56,.357,6,27,.222,14,29,.483,.411,1,3,.333,1,19,20,12,1,1,8,13,47
296,Thanasis Antetokounmpo\antetth01,SF,29,MIL,17,5,230,25,54,.463,0,5,.000,25,49,.510,.463,10,17,.588,19,38,57,14,9,2,11,32,60
297,John Konchar\konchjo01,SG,25,MEM,18,0,261,27,53,.509,6,19,.316,21,34,.618,.566,3,8,.375,19,46,65,21,10,4,11,22,63
298,Cody Zeller\zelleco01,C,29,POR,19,0,241,31,53,.585,0,4,.000,31,49,.633,.585,32,43,.744,32,45,77,16,7,3,12,38,94
299,Tony Bradley\bradlto01,C,24,CHI,17,7,222,29,52,.558,0,0,,29,52,.558,.558,4,5,.800,25,46,71,7,1,10,12,25,62
300,David Nwaba\nwabada01,SF,29,HOU,15,0,176,23,52,.442,1,13,.077,22,39,.564,.452,14,22,.636,8,38,46,10,10,4,8,15,61
301,Danuel House\houseda01,SF,28,HOU,12,1,154,16,51,.314,8,23,.348,8,28,.286,.392,11,12,.917,2,28,30,11,5,4,10,12,51
302,Aaron Nesmith\nesmiaa01,SF,22,BOS,17,0,157,16,51,.314,8,38,.211,8,13,.615,.392,2,2,1.000,6,19,25,5,4,0,8,18,42
303,Delon Wright\wrighde01,SG,29,ATL,19,0,244,17,51,.333,5,17,.294,12,34,.353,.382,11,15,.733,16,33,49,37,12,2,8,5,50
304,Maxi Kleber\klebima01,PF,30,DAL,9,1,199,24,50,.480,14,34,.412,10,16,.625,.620,7,8,.875,11,40,51,10,5,10,4,20,69
305,Marcus Morris\morrima03,PF,32,LAC,5,5,143,18,50,.360,7,26,.269,11,24,.458,.430,5,6,.833,2,15,17,8,3,3,8,17,48
306,Tre Jones\jonestr01,PG,22,SAS,16,0,140,28,49,.571,0,3,.000,28,46,.609,.571,8,8,1.000,1,14,15,21,4,0,9,10,64
307,Goga Bitadze\bitadgo01,C,22,IND,15,0,132,14,48,.292,4,24,.167,10,24,.417,.333,10,15,.667,16,19,35,3,9,9,5,25,42
308,Sterling Brown\brownst02,SG,26,DAL,16,0,191,15,48,.313,9,33,.273,6,15,.400,.406,4,4,1.000,10,39,49,11,6,2,9,19,43
309,James Johnson\johnsja01,PF,34,BRK,12,0,195,20,48,.417,2,10,.200,18,38,.474,.438,3,10,.300,12,30,42,17,5,4,7,27,45
310,D.J. Augustin\augusdj01,PG,34,HOU,17,0,210,18,47,.383,13,35,.371,5,12,.417,.521,14,15,.933,2,11,13,33,3,0,20,11,63
311,Dwight Howard\howardw01,C,36,LAL,19,0,258,31,47,.660,5,7,.714,26,40,.650,.713,24,39,.615,25,68,93,8,15,11,17,34,91
312,Semi Ojeleye\ojelese01,PF,27,MIL,11,0,218,12,47,.255,6,28,.214,6,19,.316,.319,3,5,.600,21,19,40,4,4,5,5,17,33
313,Payton Pritchard\pritcpa01,SG,24,BOS,18,0,158,10,47,.213,7,30,.233,3,17,.176,.287,3,3,1.000,6,14,20,20,0,2,12,14,30
314,Rodney Hood\hoodro01,SF,29,MIL,14,0,213,16,46,.348,11,32,.344,5,14,.357,.467,7,7,1.000,4,25,29,10,4,0,2,12,50
315,Austin Reaves\reaveau01,SG,23,LAL,11,0,219,22,46,.478,9,28,.321,13,18,.722,.576,8,8,1.000,2,18,20,11,3,2,10,22,61
316,Isaiah Joe\joeis01,SG,22,PHI,13,0,124,15,45,.333,10,34,.294,5,11,.455,.444,4,4,1.000,2,14,16,8,1,0,4,9,44
317,Mychal Mulder\muldemy01,PG,27,ORL,9,1,105,12,45,.267,9,30,.300,3,15,.200,.367,2,2,1.000,2,8,10,1,2,1,3,6,35
318,Cameron Thomas\thomaca02,SG,20,BRK,13,0,106,14,44,.318,2,19,.105,12,25,.480,.341,9,11,.818,2,9,11,8,3,3,3,4,39
319,Trey Burke\burketr01,PG,29,DAL,9,0,95,20,43,.465,7,16,.438,13,27,.481,.547,10,11,.909,0,7,7,11,4,0,8,6,57
320,Andre Iguodala\iguodan01,SF,38,GSW,12,0,250,18,43,.419,5,23,.217,13,20,.650,.477,4,6,.667,8,34,42,45,9,10,9,12,45
321,Paul Millsap\millspa01,PF,36,BRK,15,0,163,15,43,.349,5,21,.238,10,22,.455,.407,8,11,.727,10,39,49,11,3,5,7,31,43
322,Keita Bates-Diop\bateske01,SF,26,SAS,14,3,193,19,42,.452,1,10,.100,18,32,.563,.464,4,4,1.000,10,35,45,3,5,6,9,7,43
323,Troy Brown Jr.\browntr01,SF,22,CHI,13,0,124,18,42,.429,7,20,.350,11,22,.500,.512,2,4,.500,3,18,21,6,2,0,3,10,45
324,Malachi Flynn\flynnma01,PG,23,TOR,15,0,116,15,42,.357,5,17,.294,10,25,.400,.417,3,5,.600,5,14,19,14,7,2,3,12,38
325,Oshae Brissett\brissos01,SF,23,IND,12,0,133,17,41,.415,6,20,.300,11,21,.524,.488,2,7,.286,5,20,25,6,2,2,9,10,42
326,Gorgui Dieng\dienggo01,C,32,ATL,19,0,159,15,40,.375,4,17,.235,11,23,.478,.425,9,14,.643,19,47,66,13,5,5,11,22,43
327,Willy Hernangómez\hernawi01,C,27,NOP,8,0,101,28,40,.700,2,2,1.000,26,38,.684,.725,11,14,.786,10,33,43,15,4,2,10,14,69
328,Garrison Mathews\mathega01,SG,25,HOU,6,1,136,18,40,.450,13,35,.371,5,5,1.000,.613,8,11,.727,7,10,17,3,2,2,2,17,57
329,Jonathan Kuminga\kuminjo01,SF,19,GSW,13,0,101,16,39,.410,2,14,.143,14,25,.560,.436,8,13,.615,7,16,23,5,4,2,8,17,42
330,Isaiah Roby\robyis01,PF,23,OKC,9,1,94,19,39,.487,3,9,.333,16,30,.533,.526,6,6,1.000,10,12,22,6,1,2,4,11,47
331,Justise Winslow\winslju01,SF,25,LAC,15,0,122,14,39,.359,1,8,.125,13,31,.419,.372,2,4,.500,7,25,32,14,6,5,14,11,31
332,Marvin Bagley III\baglema01,PF,22,SAC,8,0,140,18,38,.474,4,14,.286,14,24,.583,.526,7,12,.583,10,32,42,6,1,1,6,8,47
333,Luka Garza\garzalu01,C,23,DET,11,2,128,17,38,.447,5,14,.357,12,24,.500,.513,8,10,.800,11,15,26,7,5,1,3,19,47
334,Rudy Gay\gayru01,PF,35,UTA,6,0,110,22,38,.579,14,22,.636,8,16,.500,.763,4,6,.667,3,26,29,9,1,2,6,7,62
335,Nick Richards\richani01,C,24,CHO,17,0,155,25,38,.658,0,0,,25,38,.658,.658,9,12,.750,17,19,36,4,4,12,12,28,59
336,Robin Lopez\lopezro01,C,33,ORL,8,1,121,22,37,.595,0,1,.000,22,36,.611,.595,10,16,.625,12,9,21,8,0,5,9,14,54
337,Théo Maledon\maledth01,PG,20,OKC,10,0,141,8,37,.216,3,24,.125,5,13,.385,.257,7,8,.875,4,14,18,12,2,0,11,8,26
338,Amir Coffey\coffeam01,SG,24,LAC,15,2,183,11,36,.306,8,27,.296,3,9,.333,.417,16,17,.941,3,20,23,11,1,2,5,13,46
339,Enes Kanter\kanteen01,C,29,BOS,10,0,123,16,36,.444,1,2,.500,15,34,.441,.458,14,16,.875,24,33,57,2,2,5,7,13,47
340,Jordan McLaughlin\mclaujo01,PG,25,MIN,16,0,165,11,36,.306,3,17,.176,8,19,.421,.347,5,7,.714,2,11,13,34,9,0,11,6,30
341,Willie Cauley-Stein\caulewi01,C,28,DAL,18,2,177,16,35,.457,1,2,.500,15,33,.455,.471,1,2,.500,13,25,38,9,6,3,7,17,34
342,Abdel Nader\naderab01,SF,28,PHO,14,0,145,12,35,.343,4,14,.286,8,21,.381,.400,6,10,.600,4,23,27,7,8,4,11,20,34
343,Paul Reed\reedpa01,C,22,PHI,14,2,137,18,35,.514,0,3,.000,18,32,.563,.514,0,0,,16,22,38,8,9,9,6,21,36
344,Brad Wanamaker\wanambr01,PG,32,IND,11,0,138,10,35,.286,4,12,.333,6,23,.261,.343,14,16,.875,3,16,19,21,2,5,14,19,38
345,Dylan Windler\windldy01,SF,25,CLE,14,0,166,16,35,.457,9,23,.391,7,12,.583,.586,3,4,.750,7,21,28,16,3,2,8,17,44
346,Josh Christopher\chrisjo01,SG,20,HOU,11,0,84,13,34,.382,3,8,.375,10,26,.385,.426,4,6,.667,2,8,10,11,6,0,7,5,33
347,Goran Dragić\dragigo01,PG,35,TOR,5,2,90,13,34,.382,4,14,.286,9,20,.450,.441,10,10,1.000,2,12,14,9,5,1,1,8,40
348,Zeke Nnaji\nnajize01,PF,21,DEN,7,0,80,17,34,.500,9,15,.600,8,19,.421,.632,6,10,.600,9,18,27,0,0,3,4,4,49
349,Josh Okogie\okogijo01,SG,23,MIN,12,4,173,12,34,.353,3,12,.250,9,22,.409,.397,8,16,.500,12,19,31,11,8,3,8,14,35
350,Denzel Valentine\valende01,SG,28,CLE,12,0,86,9,33,.273,6,21,.286,3,12,.250,.364,0,0,,6,10,16,3,5,0,4,8,24
351,Jaylen Nowell\nowelja01,SG,22,MIN,9,0,51,10,31,.323,1,8,.125,9,23,.391,.339,2,2,1.000,3,6,9,9,3,2,1,1,23
352,Santi Aldama\aldamsa01,PF,21,MEM,9,0,69,11,30,.367,3,15,.200,8,15,.533,.417,3,5,.600,6,11,17,8,0,2,0,7,28
353,Elfrid Payton\paytoel01,PG,27,PHO,6,0,83,16,30,.533,0,1,.000,16,29,.552,.533,4,8,.500,5,14,19,17,3,0,7,8,36
354,Taj Gibson\gibsota01,C,36,NYK,10,0,202,14,29,.483,0,3,.000,14,26,.538,.483,7,8,.875,21,30,51,8,4,14,9,34,35
355,Saben Lee\leesa01,PG,22,DET,8,0,93,10,29,.345,2,12,.167,8,17,.471,.379,6,10,.600,1,11,12,11,7,1,5,4,28
356,Jared Butler\butleja02,SG,21,UTA,13,0,62,8,28,.286,4,16,.250,4,12,.333,.357,2,4,.500,0,7,7,7,2,6,7,13,22
357,Chris Chiozza\chiozch01,PG,26,GSW,9,0,97,9,28,.321,7,20,.350,2,8,.250,.446,1,1,1.000,3,7,10,11,5,0,7,13,26
358,Ignas Brazdeikis\brazdig01,SF,23,ORL,10,0,86,7,27,.259,3,16,.188,4,11,.364,.315,1,2,.500,5,12,17,5,2,0,3,10,18
359,Moses Moody\moodymo01,SG,19,GSW,15,0,88,10,27,.370,2,15,.133,8,12,.667,.407,1,2,.500,1,10,11,3,0,2,1,4,23
360,Nerlens Noel\noelne01,C,27,NYK,8,3,198,14,27,.519,0,2,.000,14,25,.560,.519,9,9,1.000,20,31,51,6,10,13,10,28,37
361,Lamar Stevens\stevela01,PF,24,CLE,10,0,99,7,27,.259,2,8,.250,5,19,.263,.296,1,1,1.000,7,7,14,1,2,2,2,9,17
362,Boban Marjanović\marjabo01,C,33,DAL,9,0,45,18,26,.692,0,0,,18,26,.692,.692,5,10,.500,5,7,12,2,0,1,5,11,41
363,Sam Merrill\merrisa01,SG,25,MEM,6,0,58,8,24,.333,7,23,.304,1,1,1.000,.479,2,4,.500,1,6,7,4,0,0,2,3,25
364,Jabari Parker\parkeja01,PF,26,BOS,7,0,76,13,24,.542,5,9,.556,8,15,.533,.646,6,6,1.000,3,14,17,4,3,1,5,11,37
365,Dennis Smith Jr.\smithde03,PG,24,POR,9,0,118,9,24,.375,2,5,.400,7,19,.368,.417,6,11,.545,1,12,13,23,13,2,13,8,26
366,Serge Ibaka\ibakase01,C,32,LAC,6,0,61,6,23,.261,1,7,.143,5,16,.313,.283,5,8,.625,4,11,15,3,1,3,5,10,18
367,Patrick Williams\willipa01,PF,20,CHI,5,5,125,13,23,.565,3,6,.500,10,17,.588,.630,4,4,1.000,1,10,11,3,3,2,2,9,33
368,Markus Howard\howarma02,SG,22,DEN,9,0,48,6,22,.273,4,15,.267,2,7,.286,.364,4,4,1.000,0,1,1,4,3,0,2,1,20
369,Brandon Boston Jr.\bostobr01,SG,20,LAC,7,0,55,7,21,.333,2,6,.333,5,15,.333,.381,4,5,.800,0,7,7,3,4,1,2,2,20
370,Alize Johnson\johnsal02,PF,25,CHI,13,0,97,12,21,.571,0,1,.000,12,20,.600,.571,3,5,.600,13,17,30,8,3,0,6,12,27
371,Timothé Luwawu-Cabarrot\luwawti01,SF,26,ATL,14,0,53,7,21,.333,5,14,.357,2,7,.286,.452,5,6,.833,0,8,8,4,2,0,2,5,24
372,Nicolas Claxton\claxtni01,C,22,BRK,4,3,76,11,20,.550,0,0,,11,20,.550,.550,4,9,.444,3,19,22,3,0,4,3,5,26
373,Tony Snell\snellto01,SG,30,POR,14,0,126,5,20,.250,5,18,.278,0,2,.000,.375,0,0,,1,11,12,6,1,2,2,13,15
374,Jay Scrubb\scrubja01,SG,21,LAC,6,0,32,9,19,.474,3,8,.375,6,11,.545,.553,1,2,.500,0,3,3,2,1,1,1,3,22
375,Killian Tillie\tilliki02,C,23,MEM,7,0,53,6,19,.316,3,11,.273,3,8,.375,.395,0,0,,4,2,6,2,4,5,1,5,15
376,Charles Bassey\bassech01,PF,21,PHI,10,0,81,12,18,.667,0,3,.000,12,15,.800,.667,5,7,.714,10,19,29,2,1,7,3,11,29
377,Greg Brown III\browngr01,SF,20,POR,7,0,34,7,18,.389,0,4,.000,7,14,.500,.389,2,5,.400,4,8,12,4,2,3,2,5,16
378,Jarrett Culver\culveja01,SG,22,MEM,6,0,49,8,17,.471,2,7,.286,6,10,.600,.529,4,6,.667,1,6,7,5,1,0,2,0,22
379,Damian Jones\jonesda03,C,26,SAC,9,0,82,12,17,.706,1,2,.500,11,15,.733,.735,7,11,.636,11,14,25,5,0,3,2,12,32
380,Sandro Mamukelashvili\mamuksa01,PF,22,MIL,10,0,70,8,17,.471,3,7,.429,5,10,.500,.559,2,3,.667,4,7,11,2,0,1,2,5,21
381,Day'Ron Sharpe\sharpda01,PF,20,BRK,8,0,36,9,17,.529,1,3,.333,8,14,.571,.559,2,5,.400,8,9,17,0,2,2,6,4,21
382,Aaron Wiggins\wiggiaa01,G,23,OKC,7,1,109,7,17,.412,5,15,.333,2,2,1.000,.559,2,5,.400,1,10,11,9,3,1,7,9,21
383,Solomon Hill\hillso01,PF,30,ATL,10,1,109,2,16,.125,2,10,.200,0,6,.000,.188,0,0,,6,13,19,10,4,2,1,15,6
384,Matt Thomas\thomama02,SG,27,CHI,7,0,30,4,16,.250,1,7,.143,3,9,.333,.281,0,0,,0,2,2,0,1,1,0,1,9
385,Bol Bol\bolbo01,PF,22,DEN,9,0,46,7,15,.467,0,3,.000,7,12,.583,.467,1,3,.333,2,12,14,2,1,2,0,3,15
386,Quentin Grimes\grimequ01,SG,21,NYK,8,0,55,5,15,.333,5,13,.385,0,2,.000,.500,0,0,,2,5,7,1,0,0,3,5,15
387,Ben McLemore\mclembe01,SG,28,POR,5,0,33,6,15,.400,5,14,.357,1,1,1.000,.567,2,2,1.000,1,0,1,1,0,0,3,2,19
388,KZ Okpala\okpalkz01,PF,22,MIA,8,0,47,4,15,.267,1,8,.125,3,7,.429,.300,2,2,1.000,4,7,11,2,1,0,0,4,11
389,Usman Garuba\garubus01,PF,19,HOU,7,0,45,5,14,.357,2,8,.250,3,6,.500,.429,0,0,,6,12,18,6,2,4,2,4,12
390,Juan Hernangómez\hernaju01,PF,26,BOS,11,0,39,3,14,.214,1,8,.125,2,6,.333,.250,4,5,.800,3,7,10,0,4,0,3,3,11
391,Omer Yurtseven\yurtsom01,C,23,MIA,11,0,36,8,14,.571,0,0,,8,14,.571,.571,3,4,.750,2,6,8,1,0,1,3,2,19
392,Leandro Bolmaro\bolmale01,SF,21,MIN,9,0,47,5,13,.385,1,5,.200,4,8,.500,.423,4,5,.800,5,9,14,4,0,0,6,4,15
393,CJ Elleby\ellebcj01,SF,21,POR,8,0,42,4,13,.308,1,6,.167,3,7,.429,.346,0,0,,1,11,12,3,0,0,3,5,9
394,Rodney McGruder\mcgruro01,SG,30,DET,8,0,43,5,13,.385,2,7,.286,3,6,.500,.462,2,2,1.000,2,4,6,3,0,1,0,1,14
395,Jahmi'us Ramsey\ramseja01,SG,20,SAC,6,0,44,5,13,.385,1,5,.200,4,8,.500,.423,2,4,.500,0,0,0,2,0,1,0,3,13
396,Trent Forrest\forretr01,PG,23,UTA,14,0,105,7,12,.583,0,2,.000,7,10,.700,.583,6,6,1.000,2,11,13,7,4,0,7,9,20
397,Georgios Kalaitzakis\kalaige01,SF,23,MIL,9,0,48,5,11,.455,2,4,.500,3,7,.429,.545,4,9,.444,4,4,8,0,1,1,4,8,16
398,Louis King\kinglo02,SF,22,SAC,1,0,21,4,11,.364,3,8,.375,1,3,.333,.500,1,2,.500,0,4,4,0,2,0,0,1,12
399,Jalen Smith\smithja04,PF,21,PHO,6,0,32,4,11,.364,0,2,.000,4,9,.444,.364,5,5,1.000,4,10,14,0,1,1,1,3,13
400,Jalen Johnson\johnsja05,PF,20,ATL,7,0,19,5,10,.500,2,4,.500,3,6,.500,.600,2,2,1.000,0,5,5,0,0,0,0,0,14
401,Jake Layman\laymaja01,SF,27,MIN,7,0,34,3,10,.300,1,4,.250,2,6,.333,.350,0,0,,1,4,5,0,1,1,2,1,7
402,Jose Alvarado\alvarjo01,PG,23,NOP,6,0,32,3,9,.333,1,4,.250,2,5,.400,.389,0,0,,1,3,4,8,2,0,0,3,7
403,Ed Davis\davised01,C,32,CLE,6,2,67,6,9,.667,0,0,,6,9,.667,.667,1,2,.500,4,22,26,1,2,3,2,7,13
404,Josh Green\greenjo02,SG,21,DAL,8,0,39,3,9,.333,0,2,.000,3,7,.429,.333,0,0,,4,6,10,3,1,1,2,4,6
405,Isaiah Jackson\jacksis01,PF,20,IND,4,0,25,3,9,.333,0,0,,3,9,.333,.333,1,2,.500,3,5,8,0,1,1,0,6,7
406,Brook Lopez\lopezbr01,C,33,MIL,1,1,28,3,9,.333,2,4,.500,1,5,.200,.444,0,0,,2,3,5,0,1,3,0,3,8
407,Miles McBride\mcbrimi01,PG,21,NYK,6,0,8,1,9,.111,0,6,.000,1,3,.333,.111,0,0,,1,0,1,1,1,1,0,1,2
408,Yuta Watanabe\watanyu01,SF,27,TOR,2,0,27,1,9,.111,1,5,.200,0,4,.000,.167,3,4,.750,3,2,5,1,2,2,0,4,6
409,Justin Champagnie\champju01,SF,20,TOR,9,0,36,2,8,.250,0,1,.000,2,7,.286,.250,4,4,1.000,6,4,10,1,0,1,0,6,8
410,Sekou Doumbouya\doumbse01,PF,21,LAL,2,0,16,5,8,.625,1,2,.500,4,6,.667,.688,3,4,.750,2,4,6,0,3,2,2,1,14
411,Anthony Gill\gillan01,PF,29,WAS,5,0,31,5,8,.625,2,2,1.000,3,6,.500,.750,0,0,,4,5,9,1,0,2,1,3,12
412,Petr Cornelie\cornepe01,PF,26,DEN,5,0,21,2,7,.286,0,4,.000,2,3,.667,.286,0,0,,5,3,8,3,0,0,2,3,4
413,Gabriel Deck\deckga01,PF,26,OKC,5,0,23,4,7,.571,1,2,.500,3,5,.600,.643,0,0,,1,2,3,1,1,0,1,0,9
414,Jock Landale\landajo01,C,26,SAS,5,0,16,5,7,.714,1,2,.500,4,5,.800,.786,2,3,.667,2,0,2,2,0,1,1,1,13
415,James Bouknight\bouknja01,SG,21,CHO,7,0,12,0,6,.000,0,1,.000,0,5,.000,.000,2,2,1.000,1,1,2,2,0,0,0,1,2
416,Kessler Edwards\edwarke02,F,21,BRK,2,0,12,3,6,.500,2,4,.500,1,2,.500,.667,0,0,,1,2,3,0,0,0,1,0,8
417,Udonis Haslem\hasleud01,C,41,MIA,4,0,17,3,6,.500,0,1,.000,3,5,.600,.500,0,0,,1,4,5,1,0,1,0,5,6
418,Skylar Mays\mayssk01,SG,24,ATL,7,0,19,4,5,.800,1,2,.500,3,3,1.000,.900,5,5,1.000,0,2,2,1,0,0,2,2,14
419,Isaiah Todd\toddis01,PF,20,WAS,3,0,7,2,5,.400,2,3,.667,0,2,.000,.600,1,2,.500,0,1,1,0,1,1,0,0,7
420,Isaac Bonga\bongais01,SF,22,TOR,5,0,19,1,4,.250,0,2,.000,1,2,.500,.250,0,0,,1,1,2,2,1,1,0,3,2
421,Vlatko Čančar\cancavl01,PF,24,DEN,2,0,18,3,4,.750,2,2,1.000,1,2,.500,1.000,3,4,.750,1,0,1,4,1,0,1,1,11
422,Sharife Cooper\coopesh01,PG,20,ATL,5,0,11,1,4,.250,0,2,.000,1,2,.500,.250,0,0,,0,0,0,4,0,0,1,0,2
423,Nathan Knight\knighna01,PF,24,MIN,8,0,21,4,4,1.000,0,0,,4,4,1.000,1.000,6,8,.750,1,4,5,3,1,1,2,2,14
424,Kevin Knox\knoxke01,SF,22,NYK,4,0,15,1,4,.250,0,2,.000,1,2,.500,.250,1,2,.500,2,0,2,1,0,0,2,1,3
425,Eugene Omoruyi\omorueu01,SF,24,DAL,2,0,10,2,4,.500,1,2,.500,1,2,.500,.625,2,4,.500,1,4,5,1,0,0,0,1,7
426,Tyler Cook\cookty01,PF,24,CHI,1,0,12,2,3,.667,0,0,,2,3,.667,.667,2,2,1.000,0,2,2,2,0,0,1,1,6
427,Devon Dotson\dotsode01,PG,22,CHI,2,0,13,1,3,.333,0,2,.000,1,1,1.000,.333,0,0,,0,5,5,3,0,0,1,2,2
428,Didi Louzada\louzama01,SF,22,NOP,2,0,7,0,3,.000,0,3,.000,0,0,,.000,0,0,,2,0,2,1,0,0,0,0,0
429,Miye Oni\onimi01,SG,24,UTA,9,0,28,1,3,.333,0,2,.000,1,1,1.000,.333,0,1,.000,0,4,4,3,0,0,1,3,2
430,Kevin Pangos\pangoke01,PG,29,CLE,5,0,13,1,3,.333,1,2,.500,0,1,.000,.500,1,2,.500,1,0,1,0,0,0,1,2,4
431,Joshua Primo\primojo01,SG,19,SAS,4,0,14,2,3,.667,1,2,.500,1,1,1.000,.833,0,0,,1,0,1,1,0,0,0,1,5
432,Jericho Sims\simsje01,PF,23,NYK,8,0,54,3,3,1.000,0,0,,3,3,1.000,1.000,3,4,.750,2,12,14,0,2,3,2,4,9
433,Ish Wainright\wainris01,F,27,PHO,3,0,7,1,3,.333,0,1,.000,1,2,.500,.333,0,0,,1,1,2,1,0,0,1,1,2
434,Duane Washington Jr.\washidu02,PG,21,IND,2,0,4,2,3,.667,1,2,.500,1,1,1.000,.833,0,0,,0,1,1,0,0,0,0,0,5
435,Moses Brown\brownmo01,C,22,DAL,6,0,18,2,2,1.000,0,0,,2,2,1.000,1.000,2,6,.333,1,4,5,0,0,2,0,2,6
436,Tacko Fall\fallta01,C,26,CLE,7,0,19,1,2,.500,0,0,,1,2,.500,.500,1,4,.250,1,4,5,0,0,1,1,0,3
437,Sam Hauser\hausesa01,F,24,BOS,2,0,5,0,2,.000,0,2,.000,0,0,,.000,0,0,,0,1,1,0,1,0,0,1,0
438,Elijah Hughes\hugheel01,SF,23,UTA,5,0,14,0,2,.000,0,1,.000,0,1,.000,.000,2,2,1.000,0,1,1,0,0,0,0,1,2
439,Vit Krejci\krejcvi01,SG,21,OKC,3,0,9,0,2,.000,0,2,.000,0,0,,.000,2,2,1.000,0,3,3,0,0,0,1,0,2
440,Trendon Watford\watfotr01,F,21,POR,1,0,7,1,2,.500,0,0,,1,2,.500,.500,0,0,,0,0,0,2,0,0,0,0,2
441,Udoka Azubuike\azubuud01,C,22,UTA,4,0,8,1,1,1.000,0,0,,1,1,1.000,1.000,0,0,,1,3,4,0,0,0,1,0,2
442,Vernon Carey Jr.\careyve01,C,20,CHO,1,0,1,0,1,.000,0,0,,0,1,.000,.000,0,0,,0,1,1,0,0,0,0,0,0
443,Jeff Dowtin\dowtije01,PG,24,GSW,2,0,6,0,1,.000,0,0,,0,1,.000,.000,0,0,,0,2,2,0,0,0,0,1,0
444,Marcus Garrett\garrema01,SG,23,MIA,4,0,10,0,1,.000,0,0,,0,1,.000,.000,0,0,,0,1,1,2,0,0,0,1,0
445,Aaron Henry\henryaa01,SF,22,PHI,1,0,2,0,1,.000,0,1,.000,0,0,,.000,0,0,,0,0,0,0,0,0,0,0,0
446,Jay Huff\huffja01,C,23,LAL,1,0,8,0,1,.000,0,1,.000,0,0,,.000,0,0,,1,1,2,1,0,0,0,0,0
447,Chandler Hutchison\hutchch01,SF,25,PHO,3,0,9,1,1,1.000,0,0,,1,1,1.000,1.000,0,0,,0,4,4,1,0,0,3,1,2
448,Kai Jones\joneska01,C,21,CHO,6,0,8,1,1,1.000,0,0,,1,1,1.000,1.000,0,0,,0,1,1,0,0,0,3,0,2
449,RJ Nembhard\nembhrj01,SG,22,CLE,2,0,3,1,1,1.000,0,0,,1,1,1.000,1.000,0,0,,0,1,1,1,0,0,0,0,2
450,Jamorko Pickett\pickeja01,PF,24,DET,3,0,9,1,1,1.000,1,1,1.000,0,0,,1.500,0,0,,0,0,0,0,0,0,1,0,3
451,Yves Pons\ponsyv01,F,22,MEM,1,0,3,0,1,.000,0,0,,0,1,.000,.000,0,0,,1,0,1,0,0,0,0,0,0
452,Marko Simonovic\simonma01,C,22,CHI,1,0,7,0,1,.000,0,1,.000,0,0,,.000,1,2,.500,0,1,1,0,0,0,1,0,1
453,Joe Wieskamp\wieskjo01,G,22,SAS,1,0,3,1,1,1.000,1,1,1.000,0,0,,1.500,0,0,,0,0,0,0,0,0,0,0,3
454,McKinley Wright IV\wrighmc01,PG,23,MIN,1,0,4,1,1,1.000,1,1,1.000,0,0,,1.500,0,0,,0,0,0,0,0,0,1,0,3
455,Joel Ayayi\ayayijo01,SG,21,WAS,3,0,6,0,0,,0,0,,0,0,,,0,0,,0,1,1,2,0,0,0,0,0
456,Sam Dekker\dekkesa01,PF,27,TOR,1,0,1,0,0,,0,0,,0,0,,,0,0,,0,0,0,0,0,0,0,0,0
457,Bruno Fernando\fernabr01,C,23,BOS,7,0,13,0,0,,0,0,,0,0,,,0,0,,0,1,1,1,0,1,2,2,0
458,Malik Fitts\fittsma01,PF,24,UTA,3,0,7,0,0,,0,0,,0,0,,,0,0,,0,2,2,0,0,0,0,0,0
459,DeJon Jarreau\jarrede01,SG,24,IND,1,0,1,0,0,,0,0,,0,0,,,0,0,,0,0,0,0,0,0,0,0,0
460,David Johnson\johnsda08,SG,20,TOR,1,0,0,0,0,,0,0,,0,0,,,0,0,,0,0,0,0,0,0,0,0,0
461,Keon Johnson\johnske07,SG,19,LAC,1,0,1,0,0,,0,0,,0,0,,,0,0,,0,0,0,0,0,0,0,0,0
462,JaQuori McLaughlin\mclauja01,PG,24,DAL,1,0,2,0,0,,0,0,,0,0,,,0,0,,0,0,0,1,0,0,0,0,0
463,Wayne Selden\seldewa01,SG,27,NYK,1,0,1,0,0,,0,0,,0,0,,,0,0,,0,0,0,0,0,0,0,0,0
464,Jaden Springer\sprinja01,SG,19,PHI,1,0,2,0,0,,0,0,,0,0,,,0,0,,0,0,0,0,0,0,0,0,0
465,Brodric Thomas\thomabr01,SG,25,BOS,2,0,2,0,0,,0,0,,0,0,,,0,0,,1,0,1,0,0,0,1,0,0
466,JT Thor\thorjt01,PF,19,CHO,2,0,2,0,0,,0,0,,0,0,,,0,0,,0,0,0,0,0,0,0,0,0
467,Robert Woodard\woodaro01,SF,22,SAC,1,0,3,0,0,,0,0,,0,0,,,0,0,,0,0,0,0,0,0,0,0,0
