Rk,Player,Pos,Age,Tm,G,GS,MP,FG,FGA,FG%,3P▼,3PA,3P%,2P,2PA,2P%,eFG%,FT,FTA,FT%,ORB,DRB,TRB,AST,STL,BLK,TOV,PF,PTS
1,Stephen Curry\curryst01,PG,33,GSW,23,23,787,206,469,.439,126,303,.416,80,166,.482,.574,99,106,.934,14,115,129,150,41,11,71,41,637
2,Buddy Hield\hieldbu01,SG,29,SAC,24,2,688,127,327,.388,87,239,.364,40,88,.455,.521,41,49,.837,18,84,102,54,16,6,39,51,382
3,CJ McCollum\mccolcj01,SG,30,POR,24,24,848,191,451,.424,77,196,.393,114,255,.447,.509,35,50,.700,27,72,99,107,26,17,46,51,494
4,Kelly Oubre Jr.\oubreke01,SF,26,CHO,26,7,738,160,343,.466,76,193,.394,84,150,.560,.577,34,53,.642,31,71,102,28,26,8,24,64,430
5,Lonzo Ball\balllo01,PG,24,CHI,25,25,879,114,276,.413,75,176,.426,39,100,.390,.549,8,11,.727,25,114,139,123,42,26,58,62,311
6,Grayson Allen\allengr01,SG,26,MIL,24,24,693,110,244,.451,74,174,.425,36,70,.514,.602,29,33,.879,13,76,89,32,16,8,15,38,323
7,Patty Mills\millspa02,PG,33,BRK,24,10,687,107,233,.459,74,160,.463,33,73,.452,.618,13,14,.929,6,36,42,58,14,5,20,31,301
8,Duncan Robinson\robindu01,SG,27,MIA,25,25,704,95,258,.368,72,217,.332,23,41,.561,.508,11,15,.733,8,79,87,35,20,6,21,71,273
9,Fred VanVleet\vanvlfr01,PG,27,TOR,23,23,876,163,369,.442,72,184,.391,91,185,.492,.539,58,67,.866,17,97,114,141,34,14,74,62,456
10,Zach LaVine\lavinza01,SF,26,CHI,25,25,875,237,484,.490,71,188,.378,166,296,.561,.563,102,118,.864,9,123,132,101,13,9,64,38,647
11,LaMelo Ball\ballla01,PG,20,CHO,24,24,799,174,416,.418,70,179,.391,104,237,.439,.502,63,70,.900,37,148,185,198,46,10,78,75,481
12,Anthony Edwards\edwaran01,SG,20,MIN,24,24,877,193,456,.423,70,205,.341,123,251,.490,.500,70,88,.795,32,114,146,89,39,18,83,54,526
13,Jayson Tatum\tatumja01,SF,23,BOS,25,25,909,224,542,.413,70,209,.335,154,333,.462,.478,120,146,.822,28,191,219,92,22,19,65,61,638
14,Pat Connaughton\connapa01,SG,29,MIL,25,10,721,110,221,.498,69,161,.429,41,60,.683,.654,19,25,.760,21,100,121,36,23,8,21,36,308
15,Reggie Jackson\jacksre01,SG,31,LAC,25,25,833,164,415,.395,69,210,.329,95,205,.463,.478,34,43,.791,16,73,89,99,16,3,48,47,431
16,Trae Young\youngtr01,PG,23,ATL,25,25,855,228,500,.456,69,176,.392,159,324,.491,.525,132,149,.886,18,81,99,236,23,3,99,43,657
17,Donovan Mitchell\mitchdo01,SG,25,UTA,22,22,716,198,444,.446,68,202,.337,130,242,.537,.523,69,78,.885,20,70,90,113,38,4,66,55,533
18,Jordan Poole\poolejo01,SG,22,GSW,24,24,726,155,343,.452,67,190,.353,88,153,.575,.550,53,58,.914,8,69,77,85,25,5,60,70,430
19,Malik Beasley\beaslma01,SG,25,MIN,24,0,616,93,261,.356,65,194,.335,28,67,.418,.481,16,22,.727,9,65,74,36,15,4,15,29,267
20,Paul George\georgpa01,SF,31,LAC,24,24,861,220,521,.422,64,201,.318,156,320,.488,.484,95,108,.880,10,165,175,130,45,9,102,62,599
21,Carmelo Anthony\anthoca01,PF,37,LAL,25,3,705,120,274,.438,63,151,.417,57,123,.463,.553,49,60,.817,18,80,98,21,19,15,19,59,352
22,Devonte' Graham\grahade01,PG,26,NOP,23,23,711,107,285,.375,63,182,.346,44,103,.427,.486,38,48,.792,14,41,55,102,28,4,41,35,315
23,Luke Kennard\kennalu01,SG,25,LAC,25,1,699,94,218,.431,63,147,.429,31,71,.437,.576,15,16,.938,6,79,85,45,20,2,20,37,266
24,Desmond Bane\banede01,SF,23,MEM,24,24,690,148,312,.474,62,155,.400,86,157,.548,.574,29,32,.906,14,92,106,48,21,10,38,59,387
25,Evan Fournier\fournev01,SG,29,NYK,24,24,685,114,275,.415,62,161,.385,52,114,.456,.527,23,30,.767,11,56,67,41,23,4,32,40,313
26,Darius Garland\garlada01,PG,22,CLE,23,23,796,165,354,.466,62,159,.390,103,195,.528,.554,51,58,.879,11,56,67,167,28,2,91,41,443
27,James Harden\hardeja01,PG,32,BRK,24,24,862,142,348,.408,61,173,.353,81,175,.463,.496,152,172,.884,23,167,190,231,34,17,116,58,497
28,Tyler Herro\herroty01,SG,22,MIA,22,7,736,180,403,.447,61,154,.396,119,249,.478,.522,49,57,.860,18,103,121,84,13,1,66,30,470
29,Karl-Anthony Towns\townska01,C,26,MIN,23,23,795,199,394,.505,61,135,.452,138,259,.533,.582,99,122,.811,67,148,215,75,25,24,78,84,558
30,Jordan Clarkson\clarkjo01,SG,29,UTA,23,0,570,121,327,.370,60,204,.294,61,123,.496,.462,38,46,.826,16,55,71,47,15,5,30,39,340
31,D'Angelo Russell\russeda01,PG,25,MIN,21,21,686,138,361,.382,60,186,.323,78,175,.446,.465,63,76,.829,10,71,81,135,18,16,56,46,399
32,Bojan Bogdanović\bogdabo02,PF,32,UTA,23,23,695,129,280,.461,58,142,.408,71,138,.514,.564,71,77,.922,18,74,92,44,11,1,35,32,387
33,Miles Bridges\bridgmi02,PF,23,CHO,26,26,952,194,419,.463,57,173,.329,137,246,.557,.531,80,104,.769,33,156,189,85,32,24,46,71,525
34,Mike Conley\conlemi01,PG,34,UTA,21,21,598,107,210,.510,57,120,.475,50,90,.556,.645,28,33,.848,6,35,41,114,25,6,38,43,299
35,Gary Trent Jr.\trentga02,SG,23,TOR,22,21,753,132,318,.415,57,157,.363,75,161,.466,.505,39,42,.929,11,62,73,39,44,8,20,47,360
36,Tim Hardaway Jr.\hardati02,SG,29,DAL,23,19,735,116,302,.384,56,164,.341,60,138,.435,.477,46,63,.730,9,78,87,52,23,2,12,45,334
37,Justin Holiday\holidju01,SF,32,IND,23,15,647,82,206,.398,55,154,.357,27,52,.519,.532,8,11,.727,6,59,65,38,12,7,21,48,227
38,Damian Lillard\lillada01,PG,31,POR,20,20,714,146,368,.397,55,182,.302,91,186,.489,.471,82,90,.911,8,71,79,156,13,8,52,28,429
39,Luguentz Dort\dortlu01,SF,22,OKC,22,22,717,130,300,.433,54,161,.335,76,139,.547,.523,67,78,.859,15,72,87,41,20,8,36,62,381
40,Jaren Jackson Jr.\jacksja02,PF,22,MEM,24,24,647,130,307,.423,54,147,.367,76,160,.475,.511,64,76,.842,27,104,131,24,20,48,34,80,378
41,Nickeil Alexander-Walker\alexani01,SG,23,NOP,26,18,749,130,359,.362,53,176,.301,77,183,.421,.436,39,50,.780,27,76,103,70,24,11,39,44,352
42,Will Barton\bartowi01,SG,31,DEN,21,21,702,131,294,.446,53,139,.381,78,155,.503,.536,22,31,.710,14,97,111,87,18,9,36,28,337
43,Kentavious Caldwell-Pope\caldwke01,SG,28,WAS,25,25,725,99,229,.432,52,129,.403,47,100,.470,.546,34,38,.895,15,74,89,42,33,8,31,47,284
44,Andrew Wiggins\wiggian01,SF,26,GSW,24,24,728,166,340,.488,52,125,.416,114,215,.530,.565,64,89,.719,28,78,106,40,19,13,40,39,448
45,Alec Burks\burksal01,SG,30,NYK,24,5,592,86,207,.415,51,117,.436,35,90,.389,.539,56,68,.824,9,84,93,49,28,7,18,50,279
46,Luka Dončić\doncilu01,PG,22,DAL,19,19,662,179,403,.444,51,157,.325,128,246,.520,.507,76,110,.691,15,136,151,162,20,10,84,48,485
47,Georges Niang\niangge01,PF,28,PHI,24,5,590,95,218,.436,51,131,.389,44,87,.506,.553,27,29,.931,6,58,64,41,15,8,18,62,268
48,Devin Booker\bookede01,SG,25,PHO,21,21,676,180,393,.458,50,124,.403,130,269,.483,.522,78,91,.857,18,85,103,94,19,5,57,49,488
49,Kyle Kuzma\kuzmaky01,PF,26,WAS,25,25,814,120,283,.424,50,142,.352,70,141,.496,.512,32,49,.653,21,189,210,71,15,18,50,53,322
50,Cole Anthony\anthoco01,PG,21,ORL,19,19,646,130,309,.421,49,142,.345,81,167,.485,.500,64,73,.877,9,110,119,109,18,4,57,48,373
51,Terry Rozier\roziete01,SG,27,CHO,19,19,626,124,289,.429,49,140,.350,75,149,.503,.514,40,46,.870,12,55,67,68,25,10,26,26,337
52,Seth Curry\curryse01,SG,31,PHI,22,22,754,128,255,.502,47,116,.405,81,139,.583,.594,46,52,.885,11,53,64,58,19,3,38,52,349
53,Cameron Johnson\johnsca02,PF,25,PHO,24,0,559,80,191,.419,47,118,.398,33,73,.452,.542,21,29,.724,8,72,80,32,18,7,17,35,228
54,Ricky Rubio\rubiori01,PG,31,CLE,25,5,729,111,309,.359,47,135,.348,64,174,.368,.435,64,76,.842,11,90,101,155,29,4,68,55,333
55,Eric Gordon\gordoer01,SG,33,HOU,20,9,594,100,214,.467,46,106,.434,54,108,.500,.575,35,49,.714,3,35,38,55,12,12,48,20,281
56,Joe Ingles\inglejo01,SF,34,UTA,23,5,566,64,141,.454,46,113,.407,18,28,.643,.617,8,9,.889,11,58,69,72,12,3,25,40,182
57,Cedi Osman\osmande01,SF,26,CLE,19,0,424,76,165,.461,46,113,.407,30,52,.577,.600,20,28,.714,6,48,54,33,17,5,17,30,218
58,Jae Crowder\crowdja01,PF,31,PHO,24,24,671,75,194,.387,45,133,.338,30,61,.492,.503,27,35,.771,12,102,114,33,31,11,20,55,222
59,Chris Duarte\duartch01,SG,24,IND,24,18,710,124,296,.419,45,130,.346,79,166,.476,.495,22,31,.710,13,85,98,47,26,3,41,44,315
60,Gordon Hayward\haywago01,SF,31,CHO,26,26,888,156,350,.446,45,119,.378,111,231,.481,.510,87,102,.853,22,105,127,95,22,16,47,48,444
61,Kyle Lowry\lowryky01,PG,35,MIA,23,23,782,103,243,.424,45,144,.313,58,99,.586,.516,47,54,.870,11,94,105,175,24,8,69,64,298
62,Malik Monk\monkma01,SG,23,LAL,25,2,606,97,208,.466,45,120,.375,52,88,.591,.575,19,23,.826,10,56,66,55,18,6,32,38,258
63,Anfernee Simons\simonan01,SG,22,POR,22,3,505,100,218,.459,45,118,.381,55,100,.550,.562,18,19,.947,11,47,58,48,10,4,25,35,263
64,Myles Turner\turnemy01,C,25,IND,25,25,725,113,215,.526,45,114,.395,68,101,.673,.630,43,61,.705,38,149,187,25,14,71,34,63,314
65,Dorian Finney-Smith\finnedo01,PF,28,DAL,23,23,724,79,182,.434,44,116,.379,35,66,.530,.555,14,25,.560,40,62,102,36,36,11,20,52,216
66,Bogdan Bogdanović\bogdabo01,SG,29,ATL,20,20,564,89,199,.447,43,110,.391,46,89,.517,.555,11,14,.786,7,64,71,49,13,4,18,38,232
67,RJ Barrett\barrerj01,SF,21,NYK,23,23,720,124,305,.407,42,121,.347,82,184,.446,.475,50,71,.704,15,118,133,48,11,7,39,47,340
68,Saddiq Bey\beysa01,SF,22,DET,23,23,747,105,301,.349,42,144,.292,63,157,.401,.419,34,45,.756,45,96,141,58,23,4,30,39,286
69,Kevin Huerter\huertke01,SG,23,ATL,24,14,647,102,214,.477,42,107,.393,60,107,.561,.575,11,13,.846,7,74,81,58,8,6,30,44,257
70,Julius Randle\randlju01,PF,27,NYK,24,24,849,174,401,.434,42,126,.333,132,275,.480,.486,87,116,.750,44,194,238,129,16,17,77,67,477
71,Landry Shamet\shamela01,SG,24,PHO,23,3,455,56,149,.376,42,104,.404,14,45,.311,.517,25,30,.833,5,52,57,39,6,2,12,26,179
72,OG Anunoby\anunoog01,SF,24,TOR,15,15,560,114,265,.430,41,112,.366,73,153,.477,.508,33,40,.825,24,57,81,41,23,9,25,41,302
73,Cade Cunningham\cunnica01,PG,20,DET,18,18,570,100,264,.379,41,133,.308,59,131,.450,.456,27,32,.844,20,98,118,83,22,11,69,46,268
74,Joe Harris\harrijo01,SF,30,BRK,14,14,423,56,124,.452,41,88,.466,15,36,.417,.617,5,6,.833,5,51,56,14,7,2,16,31,158
75,Immanuel Quickley\quickim01,PG,22,NYK,24,1,504,76,195,.390,41,118,.347,35,77,.455,.495,39,42,.929,11,45,56,58,14,0,23,46,232
76,Robert Covington\covinro01,PF,31,POR,25,25,663,61,155,.394,40,115,.348,21,40,.525,.523,3,3,1.000,13,103,116,29,26,25,27,53,165
77,Kevin Durant\duranke01,PF,33,BRK,23,23,832,238,450,.529,40,106,.377,198,344,.576,.573,137,157,.873,12,165,177,124,15,16,69,37,653
78,Norman Powell\powelno01,SF,28,POR,21,21,624,121,255,.475,40,96,.417,81,159,.509,.553,75,91,.824,7,46,53,34,17,8,24,42,357
79,Malcolm Brogdon\brogdma01,PG,29,IND,21,21,746,153,338,.453,39,126,.310,114,212,.538,.510,85,97,.876,21,100,121,130,17,11,50,45,430
80,Spencer Dinwiddie\dinwisp01,PG,28,WAS,21,21,623,97,246,.394,39,113,.345,58,133,.436,.474,49,56,.875,14,89,103,110,7,4,32,45,282
81,Shai Gilgeous-Alexander\gilgesh01,PG,23,OKC,20,20,701,149,361,.413,39,132,.295,110,229,.480,.467,96,122,.787,11,87,98,98,20,13,49,42,433
82,Jerami Grant\grantje01,PF,27,DET,22,22,730,147,352,.418,39,119,.328,108,233,.464,.473,110,131,.840,21,85,106,57,25,22,45,47,443
83,Dennis Schröder\schrode01,SG,28,BOS,24,15,798,150,340,.441,39,112,.348,111,228,.487,.499,82,92,.891,16,71,87,117,23,1,63,55,421
84,Christian Wood\woodch01,C,26,HOU,23,23,729,143,307,.466,39,106,.368,104,201,.517,.529,54,94,.574,42,214,256,52,12,25,41,53,379
85,Lauri Markkanen\markkla01,PF,24,CLE,16,16,509,82,202,.406,38,114,.333,44,88,.500,.500,31,36,.861,21,77,98,19,13,9,11,23,233
86,De'Anthony Melton\meltode01,SG,23,MEM,21,12,519,82,201,.408,38,105,.362,44,96,.458,.502,13,20,.650,19,68,87,51,33,14,36,32,215
87,Kemba Walker\walkeke02,PG,31,NYK,18,18,441,76,177,.429,38,92,.413,38,85,.447,.537,20,25,.800,2,44,46,55,19,5,24,19,210
88,Harrison Barnes\barneha02,PF,29,SAC,19,19,665,110,230,.478,37,93,.398,73,137,.533,.559,104,123,.846,26,110,136,46,19,3,39,27,361
89,Furkan Korkmaz\korkmfu01,SG,24,PHI,23,5,531,76,200,.380,37,117,.316,39,83,.470,.473,21,26,.808,7,59,66,59,17,3,23,20,210
90,Bobby Portis\portibo01,C,26,MIL,20,16,563,114,243,.469,37,91,.407,77,152,.507,.545,35,43,.814,54,130,184,29,15,19,32,54,300
91,Derrick White\whitede01,SG,27,SAS,23,23,720,111,275,.404,37,124,.298,74,151,.490,.471,46,56,.821,13,69,82,117,26,21,33,50,305
92,Danny Green\greenda02,SF,34,PHI,17,14,410,47,102,.461,36,86,.419,11,16,.688,.637,4,4,1.000,11,31,42,19,24,14,18,33,134
93,Tyrese Haliburton\halibty01,SG,21,SAC,22,22,735,101,234,.432,36,96,.375,65,138,.471,.509,21,28,.750,23,61,84,120,39,16,42,28,259
94,Frank Jackson\jacksfr01,PG,23,DET,23,2,489,75,192,.391,36,121,.298,39,71,.549,.484,30,36,.833,6,24,30,17,12,5,20,33,216
95,LeBron James\jamesle01,SF,37,LAL,13,13,479,128,261,.490,36,106,.340,92,155,.594,.559,45,60,.750,10,62,72,86,22,8,47,29,337
96,Wendell Carter Jr.\cartewe01,C,22,ORL,25,25,722,128,248,.516,35,98,.357,93,150,.620,.587,38,54,.704,53,194,247,55,17,16,33,64,329
97,Doug McDermott\mcderdo01,PF,30,SAS,16,16,405,69,147,.469,35,80,.438,34,67,.507,.588,8,11,.727,8,29,37,23,3,1,10,21,181
98,Franz Wagner\wagnefr01,SF,20,ORL,25,25,790,132,300,.440,35,96,.365,97,204,.475,.498,42,53,.792,34,74,108,69,30,12,30,60,341
99,Grant Williams\willigr01,PF,23,BOS,25,9,541,62,123,.504,35,82,.427,27,41,.659,.646,21,24,.875,15,66,81,28,8,15,15,48,180
100,Bradley Beal\bealbr01,SG,28,WAS,22,22,786,188,430,.437,34,128,.266,154,302,.510,.477,84,97,.866,20,83,103,129,19,7,74,46,494
101,Wayne Ellington\ellinwa01,SG,34,LAL,17,2,345,37,91,.407,34,85,.400,3,6,.500,.593,4,4,1.000,3,22,25,11,7,2,6,18,112
102,Jrue Holiday\holidjr01,PG,31,MIL,19,18,602,120,268,.448,34,95,.358,86,173,.497,.511,21,32,.656,14,77,91,118,25,10,51,38,295
103,Brandon Ingram\ingrabr01,SF,24,NOP,19,19,659,162,365,.444,34,93,.366,128,272,.471,.490,77,91,.846,17,101,118,89,7,7,58,40,435
104,Royce O'Neale\onealro01,SF,28,UTA,21,21,659,61,126,.484,34,87,.391,27,39,.692,.619,12,17,.706,21,85,106,47,32,15,26,49,168
105,Kevin Porter Jr.\porteke02,PG,21,HOU,19,19,574,83,232,.358,34,110,.309,49,122,.402,.431,44,70,.629,16,68,84,110,25,6,76,43,244
106,Otto Porter\porteot01,PF,28,GSW,21,0,400,52,116,.448,34,83,.410,18,33,.545,.595,12,16,.750,16,81,97,24,19,7,13,30,150
107,Cam Reddish\reddica01,SF,22,ATL,21,0,472,83,201,.413,34,89,.382,49,112,.438,.498,41,46,.891,18,41,59,19,23,4,28,30,241
108,Marcus Smart\smartma01,PG,27,BOS,24,24,825,93,235,.396,34,114,.298,59,121,.488,.468,47,61,.770,13,78,91,133,51,7,47,56,267
109,Max Strus\strusma01,SF,25,MIA,18,0,364,52,116,.448,34,84,.405,18,32,.563,.595,11,16,.688,5,50,55,15,8,2,12,25,149
110,Lonnie Walker\walkelo01,SG,23,SAS,23,3,511,83,225,.369,34,119,.286,49,106,.462,.444,27,33,.818,3,63,66,58,16,8,30,30,227
111,Russell Westbrook\westbru01,PG,33,LAL,25,25,905,190,422,.450,34,107,.318,156,315,.495,.491,96,139,.691,33,161,194,217,32,4,114,78,510
112,Khris Middleton\middlkh01,SF,30,MIL,17,17,523,107,255,.420,33,100,.330,74,155,.477,.484,58,67,.866,7,83,90,87,20,3,50,32,305
113,Devin Vassell\vassede01,SF,21,SAS,18,0,450,80,171,.468,33,85,.388,47,86,.547,.564,16,22,.727,9,57,66,25,21,12,13,36,209
114,Mo Bamba\bambamo01,C,23,ORL,24,24,704,101,221,.457,32,98,.327,69,123,.561,.529,18,25,.720,54,159,213,44,20,52,36,65,252
115,Nicolas Batum\batumni01,PF,33,LAC,14,13,386,50,96,.521,32,73,.438,18,23,.783,.688,5,10,.500,7,70,77,21,16,11,11,17,137
116,Danilo Gallinari\gallida01,PF,33,ATL,22,0,472,67,161,.416,32,82,.390,35,79,.443,.516,40,43,.930,12,76,88,31,11,5,10,25,206
117,Jalen Green\greenja05,SG,19,HOU,18,18,555,87,228,.382,32,115,.278,55,113,.487,.452,46,57,.807,7,49,56,42,11,4,49,28,252
118,Dejounte Murray\murrade01,PG,25,SAS,23,23,800,182,407,.447,32,93,.344,150,314,.478,.486,37,53,.698,22,171,193,194,45,9,54,47,433
119,Terrence Ross\rosste01,SG,30,ORL,24,0,589,83,212,.392,32,108,.296,51,104,.490,.467,40,50,.800,6,46,52,47,12,4,37,28,238
120,Jaylen Brown\brownja02,SF,25,BOS,13,13,426,101,218,.463,31,85,.365,70,133,.526,.534,45,59,.763,6,62,68,29,14,6,31,35,278
121,John Collins\collijo01,PF,24,ATL,25,25,807,164,292,.562,31,75,.413,133,217,.613,.615,65,83,.783,43,153,196,54,18,34,27,72,424
122,Ja Morant\moranja01,PG,22,MEM,19,19,619,170,357,.476,31,87,.356,139,270,.515,.520,87,112,.777,25,81,106,129,30,5,60,25,458
123,Trey Murphy III\murphtr02,SF,21,NOP,25,0,372,40,108,.370,31,79,.392,9,29,.310,.514,9,10,.900,18,42,60,14,8,4,10,32,120
124,Derrick Rose\rosede01,PG,33,NYK,21,1,496,100,220,.455,31,76,.408,69,144,.479,.525,28,29,.966,16,44,60,78,18,12,32,13,259
125,Mikal Bridges\bridgmi01,SF,25,PHO,24,24,833,119,221,.538,30,74,.405,89,147,.605,.606,23,27,.852,20,77,97,45,36,13,19,52,291
126,Nikola Jokić\jokicni01,C,26,DEN,18,18,586,180,312,.577,30,80,.375,150,232,.647,.625,70,93,.753,46,197,243,123,21,13,58,46,460
127,Kevin Love\loveke01,PF,33,CLE,17,0,340,60,148,.405,30,83,.361,30,65,.462,.507,37,39,.949,21,99,120,34,4,4,17,18,187
128,Monte Morris\morrimo01,PG,26,DEN,23,23,686,121,251,.482,30,89,.337,91,162,.562,.542,6,10,.600,6,55,61,100,17,3,30,37,278
129,Jonas Valančiūnas\valanjo01,C,29,NOP,26,26,807,183,358,.511,30,65,.462,153,293,.522,.553,86,104,.827,87,225,312,63,16,23,53,83,482
130,Nikola Vučević\vucevni01,C,31,CHI,18,18,599,113,269,.420,30,83,.361,83,186,.446,.476,19,30,.633,30,160,190,69,18,18,29,42,275
131,Garrison Mathews\mathega01,SG,25,HOU,10,5,268,39,80,.488,29,69,.420,10,11,.909,.669,12,15,.800,8,23,31,4,5,3,2,25,119
132,Mike Muscala\muscami01,C,30,OKC,17,0,248,46,101,.455,29,67,.433,17,34,.500,.599,24,30,.800,7,49,56,9,7,10,7,22,145
133,Al Horford\horfoal01,C,35,BOS,21,21,613,97,211,.460,28,92,.304,69,119,.580,.526,41,48,.854,33,139,172,71,17,35,23,48,263
134,P.J. Washington\washipj01,PF,23,CHO,14,3,351,54,116,.466,28,63,.444,26,53,.491,.586,16,23,.696,18,57,75,26,11,16,20,27,152
135,Giannis Antetokounmpo\antetgi01,PF,27,MIL,22,22,713,215,406,.530,27,90,.300,188,316,.595,.563,150,221,.679,42,218,260,128,23,37,71,65,607
136,Bryn Forbes\forbebr01,SG,28,SAS,23,0,332,62,132,.470,27,66,.409,35,66,.530,.572,13,16,.813,2,26,28,16,10,1,20,18,164
137,De'Aaron Fox\foxde01,PG,24,SAC,24,24,836,180,420,.429,27,103,.262,153,317,.483,.461,96,131,.733,13,76,89,132,32,12,71,67,483
138,Davion Mitchell\mitchda01,PG,23,SAC,24,0,614,87,233,.373,27,96,.281,60,137,.438,.431,17,26,.654,16,47,63,81,19,5,26,57,218
139,Svi Mykhailiuk\mykhasv01,SF,24,TOR,24,4,448,62,143,.434,27,81,.333,35,62,.565,.528,20,22,.909,16,47,63,27,19,2,16,31,171
140,Gabe Vincent\vincega01,PG,25,MIA,22,1,381,52,118,.441,27,72,.375,25,46,.543,.555,13,16,.813,11,24,35,49,14,2,26,44,144
141,Armoni Brooks\brookar01,SG,23,HOU,19,0,246,34,94,.362,26,78,.333,8,16,.500,.500,7,8,.875,5,22,27,14,11,3,4,24,101
142,R.J. Hampton\hamptrj01,SG,20,ORL,25,0,467,67,159,.421,26,64,.406,41,95,.432,.503,32,54,.593,8,68,76,57,13,4,42,36,192
143,Keldon Johnson\johnske04,SF,22,SAS,23,23,716,128,275,.465,26,64,.406,102,211,.483,.513,49,77,.636,26,121,147,44,22,4,32,39,331
144,Tyrese Maxey\maxeyty01,PG,21,PHI,23,23,815,148,318,.465,26,72,.361,122,246,.496,.506,74,83,.892,9,79,88,112,17,14,27,55,396
145,Jordan Nwora\nworajo01,SF,23,MIL,21,0,372,55,139,.396,26,72,.361,29,67,.433,.489,11,13,.846,11,57,68,24,5,9,25,21,147
146,Kristaps Porziņģis\porzikr01,PF,26,DAL,16,16,486,113,250,.452,26,88,.295,87,162,.537,.504,60,68,.882,37,95,132,34,14,26,23,36,312
147,Jalen Suggs\suggsja01,PG,20,ORL,21,21,583,87,257,.339,26,102,.255,61,155,.394,.389,58,76,.763,16,55,71,75,24,9,67,58,258
148,Reggie Bullock\bullore01,SF,30,DAL,22,6,514,46,135,.341,25,97,.258,21,38,.553,.433,5,8,.625,5,55,60,13,6,2,14,31,122
149,Bones Hyland\hylanbo01,PG,21,DEN,15,0,237,40,104,.385,25,71,.352,15,33,.455,.505,15,16,.938,4,24,28,26,11,3,13,26,120
150,Cody Martin\martico01,SF,26,CHO,24,1,616,74,154,.481,25,51,.490,49,103,.476,.562,29,40,.725,31,72,103,57,31,12,14,41,202
151,Chris Paul\paulch01,PG,36,PHO,24,24,778,125,260,.481,25,73,.342,100,187,.535,.529,75,91,.824,6,89,95,243,48,7,58,48,350
152,Garrett Temple\templga01,SG,35,NOP,24,9,458,45,116,.388,25,69,.362,20,47,.426,.496,19,24,.792,17,51,68,26,23,14,20,43,134
153,P.J. Tucker\tuckepj01,PF,36,MIA,25,25,684,63,128,.492,25,60,.417,38,68,.559,.590,11,13,.846,40,95,135,42,17,7,20,62,162
154,Facundo Campazzo\campafa01,PG,30,DEN,22,0,414,41,101,.406,24,63,.381,17,38,.447,.525,17,21,.810,8,30,38,55,20,5,25,41,123
155,Aaron Gordon\gordoaa01,PF,26,DEN,23,23,737,123,239,.515,24,68,.353,99,171,.579,.565,48,66,.727,43,94,137,51,14,17,37,49,318
156,Jeremiah Robinson-Earl\robinje02,C,21,OKC,23,16,504,61,146,.418,24,71,.338,37,75,.493,.500,11,17,.647,40,94,134,20,13,7,20,33,157
157,Avery Bradley\bradlav01,SG,31,LAL,22,17,492,42,111,.378,23,65,.354,19,46,.413,.482,2,2,1.000,11,45,56,18,13,4,13,31,109
158,Jalen Brunson\brunsja01,PG,25,DAL,22,6,636,127,259,.490,23,68,.338,104,191,.545,.535,42,53,.792,12,71,83,107,17,1,32,41,319
159,Alex Caruso\carusal01,SG,27,CHI,23,6,658,65,147,.442,23,69,.333,42,78,.538,.520,42,49,.857,22,64,86,94,51,9,34,61,195
160,Terence Davis\daviste02,SG,24,SAC,16,5,259,50,127,.394,23,77,.299,27,50,.540,.484,11,15,.733,3,36,39,12,12,5,18,33,134
161,Maxi Kleber\klebima01,PF,30,DAL,14,3,318,36,83,.434,23,61,.377,13,22,.591,.572,12,18,.667,17,57,74,11,7,12,7,32,107
162,Jeremy Lamb\lambje01,SF,29,IND,19,0,264,43,109,.394,23,58,.397,20,51,.392,.500,30,30,1.000,7,42,49,21,9,7,11,20,139
163,Terance Mann\mannte01,SF,25,LAC,24,0,654,84,187,.449,23,68,.338,61,119,.513,.511,36,46,.783,35,87,122,56,15,2,26,56,227
164,Moritz Wagner\wagnemo01,C,24,ORL,23,0,266,44,101,.436,23,65,.354,21,36,.583,.550,26,35,.743,10,46,56,17,3,5,18,45,137
165,Darius Bazley\bazleda01,PF,21,OKC,23,23,630,73,206,.354,22,81,.272,51,125,.408,.408,26,42,.619,22,128,150,31,18,27,34,19,194
166,Nemanja Bjelica\bjeline01,C,33,GSW,24,0,340,57,121,.471,22,57,.386,35,64,.547,.562,20,28,.714,21,72,93,36,18,8,29,31,156
167,Rudy Gay\gayru01,PF,35,UTA,9,0,169,33,67,.493,22,46,.478,11,21,.524,.657,9,12,.750,8,38,46,12,2,2,8,14,97
168,George Hill\hillge01,SG,35,MIL,22,11,600,61,138,.442,22,67,.328,39,71,.549,.522,26,28,.929,20,60,80,55,18,3,23,40,170
169,Tyus Jones\jonesty01,PG,25,MEM,24,5,443,63,134,.470,22,51,.431,41,83,.494,.552,19,21,.905,4,54,58,95,19,2,17,11,167
170,Damion Lee\leeda03,SG,29,GSW,18,0,377,58,134,.433,21,63,.333,37,71,.521,.511,20,24,.833,7,51,58,20,7,2,11,24,157
171,Caris LeVert\leverca01,SG,27,IND,18,18,497,108,257,.420,21,81,.259,87,176,.494,.461,32,41,.780,7,41,48,52,14,10,25,36,269
172,Cameron Payne\payneca01,PG,27,PHO,19,0,346,65,171,.380,21,66,.318,44,105,.419,.442,33,40,.825,7,47,54,56,11,6,32,33,184
173,DeMar DeRozan\derozde01,PF,32,CHI,24,24,846,227,456,.498,20,60,.333,207,396,.523,.520,159,179,.888,15,112,127,98,22,9,49,55,633
174,Ty Jerome\jeromty01,SG,24,OKC,20,1,276,46,116,.397,20,66,.303,26,50,.520,.483,24,29,.828,6,17,23,23,14,2,10,25,136
175,Nassir Little\littlna01,SF,21,POR,21,2,470,65,136,.478,20,63,.317,45,73,.616,.551,24,29,.828,30,82,112,16,16,13,19,44,174
176,Jalen McDaniels\mcdanja01,SF,24,CHO,22,0,331,42,80,.525,20,44,.455,22,36,.611,.650,16,25,.640,13,59,72,21,8,8,13,37,120
177,Marcus Morris\morrima03,PF,32,LAC,9,9,261,40,96,.417,20,52,.385,20,44,.455,.521,9,12,.750,2,31,33,19,5,4,14,23,109
178,Naz Reid\reidna01,C,22,MIN,22,1,366,76,153,.497,20,54,.370,56,99,.566,.562,31,44,.705,29,51,80,16,12,21,17,55,203
179,Josh Richardson\richajo01,SG,28,BOS,19,0,458,66,142,.465,20,59,.339,46,83,.554,.535,24,30,.800,10,41,51,25,11,9,13,36,176
180,Deni Avdija\avdijde01,SF,21,WAS,25,0,533,56,132,.424,19,62,.306,37,70,.529,.496,21,32,.656,21,99,120,31,14,18,13,53,152
181,Patrick Beverley\beverpa01,PG,33,MIN,16,12,406,49,107,.458,19,56,.339,30,51,.588,.547,12,17,.706,23,47,70,72,14,16,19,50,129
182,Eric Bledsoe\bledser01,PG,32,LAC,25,22,666,84,204,.412,19,72,.264,65,132,.492,.458,41,49,.837,18,81,99,86,32,11,51,40,228
183,Joel Embiid\embiijo01,C,27,PHI,14,14,463,104,237,.439,19,47,.404,85,190,.447,.479,108,140,.771,28,130,158,61,13,22,40,36,335
184,Jeff Green\greenje02,C,35,DEN,23,14,559,78,165,.473,19,58,.328,59,107,.551,.530,51,63,.810,10,62,72,25,7,11,22,45,226
185,Tobias Harris\harrito02,PF,29,PHI,15,15,518,116,247,.470,19,62,.306,97,185,.524,.508,39,48,.813,16,110,126,56,7,9,25,21,290
186,Killian Hayes\hayeski01,PG,20,DET,18,18,467,40,119,.336,19,54,.352,21,65,.323,.416,16,17,.941,12,54,66,67,23,8,31,50,115
187,Trey Lyles\lylestr01,PF,26,DET,23,0,366,58,141,.411,19,65,.292,39,76,.513,.479,39,50,.780,32,64,96,17,7,4,21,31,174
188,Shake Milton\miltosh01,PG,25,PHI,19,5,485,87,188,.463,19,58,.328,68,130,.523,.513,30,34,.882,10,48,58,55,13,8,21,37,223
189,Domantas Sabonis\sabondo01,C,25,IND,26,25,886,178,311,.572,19,68,.279,159,243,.654,.603,89,117,.761,83,229,312,106,30,9,82,88,464
190,Kyle Anderson\anderky01,PF,28,MEM,21,2,455,66,154,.429,18,50,.360,48,104,.462,.487,15,19,.789,23,87,110,50,18,10,20,30,165
191,Dillon Brooks\brookdi01,SF,26,MEM,11,10,287,70,171,.409,18,55,.327,52,116,.448,.462,32,35,.914,8,28,36,31,15,2,26,38,190
192,Jevon Carter\carteje01,PG,26,BRK,24,1,299,21,74,.284,18,58,.310,3,16,.188,.405,3,4,.750,4,31,35,27,8,7,8,30,63
193,Josh Giddey\giddejo01,SG,19,OKC,21,21,617,91,226,.403,18,71,.254,73,155,.471,.442,19,28,.679,31,112,143,121,21,13,59,37,219
194,Gary Harris\harriga01,SG,27,ORL,19,9,481,57,139,.410,18,64,.281,39,75,.520,.475,11,15,.733,14,27,41,32,14,2,20,35,143
195,D.J. Augustin\augusdj01,PG,34,HOU,19,0,238,24,59,.407,17,42,.405,7,17,.412,.551,15,17,.882,2,16,18,40,4,0,21,12,80
196,Ayo Dosunmu\dosunay01,SG,22,CHI,24,1,413,59,119,.496,17,41,.415,42,78,.538,.567,10,17,.588,12,40,52,26,10,5,20,34,145
197,Josh Jackson\jacksjo02,SF,24,DET,20,3,376,53,128,.414,17,59,.288,36,69,.522,.480,23,33,.697,11,58,69,33,9,9,23,37,146
198,Zeke Nnaji\nnajize01,PF,21,DEN,11,0,157,29,56,.518,17,28,.607,12,28,.429,.670,10,16,.625,13,27,40,1,1,4,5,16,85
199,Taurean Prince\princta02,PF,27,MIN,22,6,338,32,89,.360,17,61,.279,15,28,.536,.455,12,17,.706,11,34,45,17,10,5,11,33,93
200,Jae'Sean Tate\tateja01,SF,26,HOU,23,23,649,113,225,.502,17,62,.274,96,163,.589,.540,43,55,.782,48,103,151,63,18,16,46,76,286
201,Dāvis Bertāns\bertada01,PF,29,WAS,15,0,233,23,80,.288,16,64,.250,7,16,.438,.388,14,15,.933,3,21,24,7,4,1,6,25,76
202,Timothé Luwawu-Cabarrot\luwawti01,SF,26,ATL,18,4,173,23,57,.404,16,40,.400,7,17,.412,.544,5,6,.833,1,19,20,9,3,3,3,20,67
203,Kelan Martin\martike03,SF,26,IND,19,1,319,53,127,.417,16,55,.291,37,72,.514,.480,7,11,.636,12,24,36,18,10,7,13,26,129
204,Pascal Siakam\siakapa01,PF,27,TOR,13,13,434,92,197,.467,16,48,.333,76,149,.510,.508,48,63,.762,25,67,92,48,9,11,28,45,248
205,Daniel Theis\theisda01,C,29,HOU,17,15,388,54,110,.491,16,51,.314,38,59,.644,.564,18,24,.750,18,64,82,14,7,9,21,42,142
206,Ziaire Williams\willizi02,SF,20,MEM,19,0,339,35,99,.354,16,65,.246,19,34,.559,.434,4,6,.667,5,23,28,12,8,6,11,33,90
207,Scottie Barnes\barnesc01,PF,20,TOR,22,22,784,135,276,.489,15,42,.357,120,234,.513,.516,47,65,.723,63,114,177,71,26,17,45,61,332
208,PJ Dozier\doziepj01,SG,25,DEN,18,0,340,36,99,.364,15,48,.313,21,51,.412,.439,10,13,.769,14,49,63,29,11,6,13,33,97
209,Josh Hart\hartjo01,PF,26,NOP,19,18,572,78,160,.488,15,46,.326,63,114,.553,.534,39,46,.848,19,100,119,73,18,7,26,53,210
210,De'Andre Hunter\huntede01,SF,24,ATL,11,11,306,50,111,.450,15,38,.395,35,73,.479,.518,4,10,.400,4,26,30,7,7,3,14,32,119
211,Romeo Langford\langfro01,SG,22,BOS,19,0,351,34,82,.415,15,36,.417,19,46,.413,.506,9,12,.750,16,41,57,10,8,2,10,25,92
212,Jaden McDaniels\mcdanja02,PF,21,MIN,21,11,528,53,132,.402,15,56,.268,38,76,.500,.458,7,11,.636,34,59,93,17,20,12,21,79,128
213,Chimezie Metu\metuch01,C,24,SAC,13,10,301,43,109,.394,15,56,.268,28,53,.528,.463,11,15,.733,14,73,87,14,11,12,14,15,112
214,Frank Ntilikina\ntilila01,PG,23,DAL,17,0,237,28,80,.350,15,44,.341,13,36,.361,.444,12,12,1.000,3,29,32,23,12,3,11,18,83
215,Torrey Craig\craigto01,SF,31,IND,25,1,393,52,106,.491,14,51,.275,38,55,.691,.557,17,22,.773,30,52,82,22,11,7,15,41,135
216,Caleb Martin\martica02,SF,26,MIA,22,1,416,57,123,.463,14,45,.311,43,78,.551,.520,19,32,.594,17,48,65,19,20,11,12,31,147
217,Evan Mobley\mobleev01,PF,20,CLE,21,21,711,114,245,.465,14,42,.333,100,203,.493,.494,51,65,.785,37,134,171,55,19,38,36,44,293
218,Chuma Okeke\okekech01,PF,23,ORL,19,0,404,50,131,.382,14,60,.233,36,71,.507,.435,23,27,.852,12,66,78,22,14,6,15,25,137
219,Kelly Olynyk\olynyke01,C,30,DET,10,1,230,45,98,.459,14,41,.341,31,57,.544,.531,21,35,.600,13,40,53,23,14,7,15,27,125
220,Payton Pritchard\pritcpa01,SG,24,BOS,20,0,188,18,65,.277,14,45,.311,4,20,.200,.385,5,5,1.000,6,17,23,28,1,2,13,15,55
221,Dean Wade\wadede01,PF,25,CLE,16,11,358,29,72,.403,14,47,.298,15,25,.600,.500,5,6,.833,12,40,52,21,11,1,5,32,77
222,Kenrich Williams\willike04,SF,27,OKC,20,0,410,55,119,.462,14,40,.350,41,79,.519,.521,17,30,.567,20,50,70,36,17,5,15,35,141
223,Kent Bazemore\bazemke01,SF,32,LAL,18,13,350,27,81,.333,13,43,.302,14,38,.368,.414,10,13,.769,4,31,35,15,16,5,8,42,77
224,Aaron Holiday\holidaa01,PG,25,WAS,24,7,419,57,129,.442,13,37,.351,44,92,.478,.492,13,17,.765,4,34,38,48,14,8,26,39,140
225,Isaiah Joe\joeis01,SG,22,PHI,14,0,136,18,49,.367,13,38,.342,5,11,.455,.500,4,4,1.000,2,15,17,9,2,0,6,11,53
226,Kira Lewis Jr.\lewiski01,PG,20,NOP,23,0,332,57,142,.401,13,57,.228,44,85,.518,.447,9,11,.818,9,30,39,46,10,1,25,17,136
227,Tre Mann\manntr01,PG,20,OKC,15,2,228,40,97,.412,13,37,.351,27,60,.450,.479,13,18,.722,7,20,27,4,7,5,12,20,106
228,Ben McLemore\mclembe01,SG,28,POR,10,0,113,17,42,.405,13,36,.361,4,6,.667,.560,5,5,1.000,3,5,8,7,2,0,5,7,52
229,Gary Payton II\paytoga02,PG,29,GSW,23,1,339,63,93,.677,13,32,.406,50,61,.820,.747,19,29,.655,25,50,75,18,31,3,12,40,158
230,Austin Rivers\riverau01,SG,29,DEN,18,3,314,27,78,.346,13,48,.271,14,30,.467,.429,3,6,.500,7,19,26,14,9,2,10,22,70
231,Lou Williams\willilo02,PG,35,ATL,20,0,270,46,121,.380,13,36,.361,33,85,.388,.434,22,26,.846,6,23,29,26,11,2,18,19,127
232,Oshae Brissett\brissos01,SF,23,IND,15,0,201,26,57,.456,12,28,.429,14,29,.483,.561,3,11,.273,9,31,40,7,4,4,11,15,67
233,Cory Joseph\josepco01,PG,30,DET,22,4,473,49,115,.426,12,39,.308,37,76,.487,.478,34,41,.829,7,33,40,76,18,5,30,34,144
234,Larry Nance Jr.\nancela02,PF,29,POR,25,0,507,63,117,.538,12,39,.308,51,78,.654,.590,18,29,.621,35,88,123,34,22,9,19,35,156
235,Aaron Nesmith\nesmiaa01,SF,22,BOS,20,0,199,23,65,.354,12,45,.267,11,20,.550,.446,4,4,1.000,6,24,30,8,5,0,8,27,62
236,Isaac Okoro\okorois01,SF,21,CLE,18,14,518,47,131,.359,12,55,.218,35,76,.461,.405,26,35,.743,26,47,73,33,17,5,19,42,132
237,Sterling Brown\brownst02,SG,26,DAL,20,0,256,22,62,.355,11,40,.275,11,22,.500,.444,4,4,1.000,14,50,64,15,9,3,14,24,59
238,Rodney Hood\hoodro01,SF,29,MIL,18,0,267,17,59,.288,11,40,.275,6,19,.316,.381,9,9,1.000,5,30,35,14,5,1,2,17,54
239,Corey Kispert\kispeco01,SF,22,WAS,23,0,279,32,78,.410,11,46,.239,21,32,.656,.481,11,14,.786,10,31,41,12,5,3,8,10,86
240,Raul Neto\netora01,PG,29,WAS,24,0,470,71,155,.458,11,40,.275,60,115,.522,.494,28,39,.718,4,43,47,61,18,1,30,38,181
241,Collin Sexton\sextoco01,SG,23,CLE,11,11,316,68,151,.450,11,45,.244,57,106,.538,.487,29,39,.744,13,23,36,23,10,0,31,25,176
242,Matisse Thybulle\thybuma01,SG,24,PHI,17,5,427,40,77,.519,11,37,.297,29,40,.725,.591,6,6,1.000,9,34,43,19,33,22,17,37,97
243,LaMarcus Aldridge\aldrila01,C,36,BRK,23,6,542,138,242,.570,10,29,.345,128,213,.601,.591,33,41,.805,33,101,134,20,7,25,15,38,319
244,Chris Boucher\bouchch01,PF,29,TOR,22,0,301,52,131,.397,10,54,.185,42,77,.545,.435,24,35,.686,30,57,87,7,11,17,12,31,138
245,Trey Burke\burketr01,PG,29,DAL,13,0,141,31,68,.456,10,24,.417,21,44,.477,.529,10,11,.909,0,9,9,18,5,0,12,9,82
246,Amir Coffey\coffeam01,SG,24,LAC,16,3,207,14,40,.350,10,30,.333,4,10,.400,.475,17,19,.895,3,23,26,11,1,2,5,13,55
247,JaMychal Green\greenja01,PF,31,DEN,22,4,324,46,113,.407,10,51,.196,36,62,.581,.451,14,18,.778,20,55,75,19,18,10,25,51,116
248,Javonte Green\greenja02,SF,28,CHI,23,12,474,48,97,.495,10,26,.385,38,71,.535,.546,18,24,.750,35,63,98,16,19,8,16,45,124
249,Talen Horton-Tucker\hortota01,SG,21,LAL,12,9,350,49,129,.380,10,44,.227,39,85,.459,.419,21,23,.913,8,54,62,33,12,8,19,40,129
250,Danuel House\houseda01,SF,28,HOU,16,1,233,25,74,.338,10,34,.294,15,40,.375,.405,17,19,.895,4,39,43,19,5,5,18,16,77
251,John Konchar\konchjo01,SG,25,MEM,22,0,339,36,66,.545,10,25,.400,26,41,.634,.621,3,8,.375,21,61,82,29,16,5,13,26,85
252,Mychal Mulder\muldemy01,PG,27,ORL,12,1,130,13,49,.265,10,34,.294,3,15,.200,.367,2,2,1.000,2,12,14,1,3,1,4,8,38
253,Eric Paschall\pascher01,PF,25,UTA,19,0,230,24,57,.421,10,36,.278,14,21,.667,.509,12,17,.706,13,25,38,14,2,3,10,16,70
254,Aleksej Pokusevski\pokusal01,PF,20,OKC,23,0,336,44,128,.344,10,55,.182,34,73,.466,.383,5,10,.500,24,71,95,28,9,11,28,26,103
255,Michael Porter Jr.\portemi01,SF,23,DEN,9,9,265,37,103,.359,10,48,.208,27,55,.491,.408,5,9,.556,9,50,59,17,10,2,12,16,89
256,Justin Robinson\robinju01,PG,24,MIL,17,0,198,18,57,.316,10,37,.270,8,20,.400,.404,2,2,1.000,2,11,13,21,8,0,11,17,48
257,Alperen Şengün\sengual01,C,19,HOU,22,2,395,63,129,.488,10,27,.370,53,102,.520,.527,54,77,.701,31,69,100,58,25,14,40,66,190
258,Dylan Windler\windldy01,SF,25,CLE,17,0,184,17,37,.459,10,24,.417,7,13,.538,.595,3,4,.750,7,24,31,18,3,2,8,19,47
259,DeAndre' Bembry\bembrde01,SF,27,BRK,23,8,462,58,101,.574,9,22,.409,49,79,.620,.619,9,19,.474,17,59,76,26,22,12,16,53,134
260,Chris Chiozza\chiozch01,PG,26,GSW,11,0,124,11,30,.367,9,22,.409,2,8,.250,.517,1,1,1.000,5,11,16,18,5,0,9,15,32
261,Anthony Davis\davisan02,C,28,LAL,24,24,858,230,439,.524,9,48,.188,221,391,.565,.534,109,151,.722,73,173,246,74,31,53,49,56,578
262,Blake Griffin\griffbl01,PF,32,BRK,17,17,369,34,107,.318,9,56,.161,25,51,.490,.360,16,23,.696,21,63,84,34,9,10,9,39,93
263,Maurice Harkless\harklma01,SF,28,SAC,16,14,327,25,65,.385,9,40,.225,16,25,.640,.454,8,11,.727,3,42,45,9,8,8,7,25,67
264,Kenyon Martin Jr.\martike04,SF,21,HOU,22,0,341,64,116,.552,9,31,.290,55,85,.647,.591,15,23,.652,14,54,68,20,9,10,10,24,152
265,Austin Reaves\reaveau01,SG,23,LAL,14,0,250,24,51,.471,9,30,.300,15,21,.714,.559,9,11,.818,4,22,26,13,3,2,10,24,66
266,Tony Snell\snellto01,SG,30,POR,19,3,230,13,40,.325,9,31,.290,4,9,.444,.438,1,1,1.000,2,26,28,12,4,3,4,17,36
267,Juan Toscano-Anderson\toscaju01,SF,28,GSW,23,1,378,48,88,.545,9,31,.290,39,57,.684,.597,16,24,.667,12,52,64,51,15,10,26,34,121
268,Troy Brown Jr.\browntr01,SF,22,CHI,16,0,169,23,54,.426,8,24,.333,15,30,.500,.500,7,11,.636,6,31,37,10,3,0,5,12,61
269,Serge Ibaka\ibakase01,C,32,LAC,11,3,154,17,47,.362,8,20,.400,9,27,.333,.447,5,8,.625,12,22,34,13,2,3,6,21,47
270,Markieff Morris\morrima02,PF,32,MIA,10,0,187,32,70,.457,8,22,.364,24,48,.500,.514,5,5,1.000,13,15,28,14,3,1,12,22,77
271,Delon Wright\wrighde01,SG,29,ATL,23,0,322,24,62,.387,8,21,.381,16,41,.390,.452,13,17,.765,18,47,65,49,16,3,10,12,69
272,Precious Achiuwa\achiupr01,C,22,TOR,21,17,556,71,184,.386,7,26,.269,64,158,.405,.405,19,35,.543,49,124,173,33,11,12,23,53,168
273,Bruce Brown\brownbr01,SF,25,BRK,21,14,476,60,133,.451,7,23,.304,53,110,.482,.477,9,13,.692,25,62,87,24,26,10,13,51,136
274,Dewayne Dedmon\dedmode01,C,32,MIA,25,7,392,53,96,.552,7,11,.636,46,85,.541,.589,28,36,.778,44,97,141,16,9,12,22,53,141
275,Gorgui Dieng\dienggo01,C,32,ATL,21,0,177,19,45,.422,7,21,.333,12,24,.500,.500,9,14,.643,21,51,72,15,5,6,11,26,54
276,Draymond Green\greendr01,PF,31,GSW,23,23,694,76,135,.563,7,22,.318,69,113,.611,.589,29,49,.592,27,156,183,174,32,23,72,60,188
277,Quentin Grimes\grimequ01,SG,21,NYK,12,0,76,7,19,.368,7,17,.412,0,2,.000,.553,0,0,,2,7,9,3,0,0,3,7,21
278,Derrick Jones Jr.\jonesde02,PF,24,CHI,21,1,378,54,92,.587,7,23,.304,47,69,.681,.625,28,34,.824,29,46,75,12,11,21,11,50,143
279,Herb Jones\joneshe01,C,23,NOP,23,14,607,61,134,.455,7,21,.333,54,113,.478,.481,19,24,.792,29,44,73,38,34,18,26,72,148
280,T.J. McConnell\mccontj01,PG,29,IND,24,6,581,91,181,.503,7,25,.280,84,156,.538,.522,12,15,.800,19,61,80,115,25,9,28,43,201
281,Sam Merrill\merrisa01,SG,25,MEM,6,0,58,8,24,.333,7,23,.304,1,1,1.000,.479,2,4,.500,1,6,7,4,0,0,2,3,25
282,Dwight Powell\poweldw01,C,30,DAL,23,20,459,54,91,.593,7,19,.368,47,72,.653,.632,28,40,.700,45,59,104,26,12,13,15,55,143
283,Rajon Rondo\rondora01,PG,35,LAL,14,0,208,20,63,.317,7,25,.280,13,38,.342,.373,0,0,,8,26,34,50,11,3,23,20,47
284,Obi Toppin\toppiob01,PF,23,NYK,24,0,369,76,143,.531,7,38,.184,69,105,.657,.556,35,46,.761,28,61,89,23,9,15,22,36,194
285,Denzel Valentine\valende01,SG,28,CLE,15,0,97,10,36,.278,7,23,.304,3,13,.231,.375,0,0,,6,11,17,3,5,0,6,9,27
286,Yuta Watanabe\watanyu01,SF,27,TOR,5,0,84,10,26,.385,7,17,.412,3,9,.333,.519,3,6,.500,5,9,14,3,3,2,1,8,30
287,Coby White\whiteco01,PG,21,CHI,9,1,158,22,63,.349,7,31,.226,15,32,.469,.405,4,7,.571,1,22,23,12,1,1,8,15,55
288,Dalano Banton\bantoda01,SF,22,TOR,24,0,315,42,88,.477,6,18,.333,36,70,.514,.511,18,24,.750,16,42,58,40,10,5,26,35,108
289,Brandon Boston Jr.\bostobr01,SG,20,LAC,12,0,121,18,46,.391,6,16,.375,12,30,.400,.457,12,13,.923,1,11,12,4,5,3,9,8,54
290,Jimmy Butler\butleji01,SF,32,MIA,18,18,607,139,273,.509,6,31,.194,133,242,.550,.520,127,149,.852,29,75,104,94,39,5,35,29,411
291,Malachi Flynn\flynnma01,PG,23,TOR,17,0,139,17,50,.340,6,24,.250,11,26,.423,.400,3,5,.600,5,17,22,15,8,2,5,14,43
292,Alex Len\lenal01,C,28,SAC,16,3,261,36,71,.507,6,14,.429,30,57,.526,.549,18,27,.667,15,47,62,16,3,15,18,49,96
293,Paul Millsap\millspa01,PF,36,BRK,19,0,208,22,61,.361,6,23,.261,16,38,.421,.410,12,17,.706,20,48,68,18,4,7,9,39,62
294,Semi Ojeleye\ojelese01,PF,27,MIL,11,0,218,12,47,.255,6,28,.214,6,19,.316,.319,3,5,.600,21,19,40,4,4,5,5,17,33
295,Lamar Stevens\stevela01,PF,24,CLE,15,0,158,17,46,.370,6,16,.375,11,30,.367,.435,4,7,.571,10,14,24,4,4,4,6,18,44
296,Aaron Wiggins\wiggiaa01,SG,23,OKC,9,1,130,8,18,.444,6,16,.375,2,2,1.000,.611,4,7,.571,1,13,14,10,3,1,7,15,26
297,Luka Garza\garzalu01,C,23,DET,14,2,140,18,43,.419,5,15,.333,13,28,.464,.477,11,14,.786,14,17,31,7,6,1,5,24,52
298,Dwight Howard\howardw01,C,36,LAL,22,1,326,41,64,.641,5,7,.714,36,57,.632,.680,26,42,.619,33,86,119,10,18,15,21,41,113
299,Markus Howard\howarma02,SG,22,DEN,12,0,65,8,29,.276,5,21,.238,3,8,.375,.362,4,4,1.000,0,2,2,4,4,0,3,2,25
300,Andre Iguodala\iguodan01,SF,38,GSW,12,0,250,18,43,.419,5,23,.217,13,20,.650,.477,4,6,.667,8,34,42,45,9,10,9,12,45
301,James Johnson\johnsja01,PF,34,BRK,15,0,264,32,63,.508,5,14,.357,27,49,.551,.548,6,14,.429,14,40,54,23,6,7,9,38,75
302,Frank Kaminsky\kaminfr01,C,28,PHO,9,0,181,36,66,.545,5,15,.333,31,51,.608,.583,18,20,.900,11,30,41,13,8,7,5,14,95
303,Jusuf Nurkić\nurkiju01,C,27,POR,25,25,617,128,217,.590,5,20,.250,123,197,.624,.601,74,99,.747,62,192,254,55,28,14,47,73,335
304,Jabari Parker\parkeja01,PF,26,BOS,8,0,79,13,24,.542,5,9,.556,8,15,.533,.646,6,6,1.000,3,14,17,4,3,1,5,11,37
305,Isaiah Roby\robyis01,PF,23,OKC,12,1,160,31,59,.525,5,15,.333,26,44,.591,.568,14,17,.824,12,21,33,10,3,5,8,15,81
306,Dennis Smith Jr.\smithde03,PG,24,POR,14,2,232,29,71,.408,5,16,.313,24,55,.436,.444,17,25,.680,5,25,30,45,20,4,23,18,80
307,Cameron Thomas\thomaca02,SG,20,BRK,17,0,188,26,73,.356,5,31,.161,21,42,.500,.390,11,15,.733,3,20,23,12,6,3,4,6,68
308,Marvin Bagley III\baglema01,PF,22,SAC,9,0,160,22,44,.500,4,15,.267,18,29,.621,.545,11,16,.688,14,39,53,6,1,1,7,9,59
309,Goga Bitadze\bitadgo01,C,22,IND,16,0,138,14,49,.286,4,25,.160,10,24,.417,.327,11,17,.647,16,21,37,3,9,10,5,26,43
310,Jared Butler\butleja02,SG,21,UTA,14,0,65,8,28,.286,4,16,.250,4,12,.333,.357,4,7,.571,0,7,7,7,2,6,7,13,24
311,Josh Christopher\chrisjo01,SG,20,HOU,15,0,112,16,43,.372,4,11,.364,12,32,.375,.419,7,9,.778,4,11,15,12,6,0,10,9,43
312,Hamidou Diallo\diallha01,SG,23,DET,16,1,233,40,77,.519,4,15,.267,36,62,.581,.545,14,18,.778,15,30,45,11,10,7,11,27,98
313,Goran Dragić\dragigo01,PG,35,TOR,5,2,90,13,34,.382,4,14,.286,9,20,.450,.441,10,10,1.000,2,12,14,9,5,1,1,8,40
314,Jaxson Hayes\hayesja02,C,21,NOP,19,0,232,40,77,.519,4,11,.364,36,66,.545,.545,28,37,.757,24,38,62,5,5,12,12,30,112
315,Louis King\kinglo02,SF,22,SAC,3,0,49,7,21,.333,4,14,.286,3,7,.429,.429,6,7,.857,0,7,7,1,2,0,0,7,24
316,Saben Lee\leesa01,PG,22,DET,9,0,114,13,38,.342,4,18,.222,9,20,.450,.395,7,12,.583,1,14,15,14,9,2,6,6,37
317,Sandro Mamukelashvili\mamuksa01,PF,22,MIL,12,1,114,14,31,.452,4,11,.364,10,20,.500,.516,2,3,.667,14,14,28,6,0,1,3,6,34
318,Jordan McLaughlin\mclaujo01,PG,25,MIN,17,0,187,13,41,.317,4,19,.211,9,22,.409,.366,7,9,.778,3,13,16,38,10,0,11,7,37
319,Abdel Nader\naderab01,SF,28,PHO,14,0,145,12,35,.343,4,14,.286,8,21,.381,.400,6,10,.600,4,23,27,7,8,4,11,20,34
320,Joshua Primo\primojo01,SG,19,SAS,7,0,59,6,11,.545,4,8,.500,2,3,.667,.727,0,0,,1,5,6,4,3,4,0,4,16
321,Jay Scrubb\scrubja01,SG,21,LAC,7,0,48,11,26,.423,4,12,.333,7,14,.500,.500,1,2,.500,0,4,4,4,1,2,1,3,27
322,Killian Tillie\tilliki02,C,23,MEM,10,0,77,8,23,.348,4,13,.308,4,10,.400,.435,1,2,.500,5,3,8,2,4,5,3,9,21
323,Xavier Tillman Sr.\tillmxa01,PF,23,MEM,17,0,237,31,72,.431,4,21,.190,27,51,.529,.458,13,17,.765,19,33,52,23,19,7,11,16,79
324,Brad Wanamaker\wanambr01,PG,32,IND,14,0,171,16,46,.348,4,14,.286,12,32,.375,.391,15,17,.882,4,18,22,32,2,5,15,25,51
325,Santi Aldama\aldamsa01,PF,21,MEM,13,0,136,21,59,.356,3,26,.115,18,33,.545,.381,6,10,.600,14,23,37,12,2,3,4,13,51
326,Ignas Brazdeikis\brazdig01,SF,23,ORL,12,0,98,7,28,.250,3,17,.176,4,11,.364,.304,1,2,.500,5,12,17,6,3,0,3,12,18
327,Vlatko Čančar\cancavl01,PF,24,DEN,5,0,27,4,8,.500,3,3,1.000,1,5,.200,.688,3,4,.750,1,1,2,4,1,0,2,3,14
328,Jarrett Culver\culveja01,SG,22,MEM,8,0,65,14,26,.538,3,9,.333,11,17,.647,.596,4,8,.500,2,9,11,11,3,0,2,1,35
329,CJ Elleby\ellebcj01,SF,21,POR,13,0,69,9,21,.429,3,11,.273,6,10,.600,.500,0,0,,1,15,16,4,0,0,7,11,21
330,Anthony Gill\gillan01,PF,29,WAS,9,0,43,7,10,.700,3,3,1.000,4,7,.571,.850,5,6,.833,4,9,13,1,0,2,1,3,22
331,Théo Maledon\maledth01,PG,20,OKC,12,0,155,9,40,.225,3,26,.115,6,14,.429,.263,10,12,.833,5,16,21,12,4,1,14,10,31
332,Naji Marshall\marshna01,SF,24,NOP,18,0,206,19,59,.322,3,23,.130,16,36,.444,.347,25,29,.862,13,40,53,20,8,3,18,20,66
333,Josh Okogie\okogijo01,SG,23,MIN,16,5,248,14,44,.318,3,18,.167,11,26,.423,.352,10,20,.500,15,22,37,16,11,5,8,24,41
334,Davon Reed\reedda01,SG,26,DEN,2,0,37,3,5,.600,3,3,1.000,0,2,.000,.900,0,0,,1,4,5,5,3,1,1,2,9
335,Tomáš Satoranský\satorto01,SG,30,NOP,21,3,322,22,65,.338,3,14,.214,19,51,.373,.362,12,16,.750,13,31,44,43,7,0,15,27,59
336,Ish Smith\smithis01,PG,33,CHO,18,1,245,40,96,.417,3,6,.500,37,90,.411,.432,3,8,.375,2,21,23,44,8,4,16,13,86
337,Patrick Williams\willipa01,PF,20,CHI,5,5,125,13,23,.565,3,6,.500,10,17,.588,.630,4,4,1.000,1,10,11,3,3,2,2,9,33
338,Jose Alvarado\alvarjo01,PG,23,NOP,7,0,38,5,13,.385,2,5,.400,3,8,.375,.462,2,3,.667,2,3,5,9,3,0,0,3,14
339,Keljin Blevins\blevike01,SF,26,POR,3,0,14,2,4,.500,2,3,.667,0,1,.000,.750,0,0,,0,1,1,1,0,0,2,0,6
340,Kessler Edwards\edwarke02,SF,21,BRK,2,0,12,3,6,.500,2,4,.500,1,2,.500,.667,0,0,,1,2,3,0,0,0,1,0,8
341,Derrick Favors\favorde01,C,30,OKC,17,8,284,44,88,.500,2,8,.250,42,80,.525,.511,8,14,.571,25,60,85,7,8,3,5,20,98
342,Usman Garuba\garubus01,PF,19,HOU,7,0,45,5,14,.357,2,8,.250,3,6,.500,.429,0,0,,6,12,18,6,2,4,2,4,12
343,Montrezl Harrell\harremo01,C,28,WAS,25,3,665,147,225,.653,2,8,.250,145,217,.668,.658,94,125,.752,64,142,206,56,15,18,34,49,390
344,Isaiah Hartenstein\harteis01,C,23,LAC,24,0,374,74,114,.649,2,3,.667,72,111,.649,.658,25,42,.595,43,70,113,36,19,29,22,60,175
345,Juan Hernangómez\hernaju01,PF,26,BOS,13,0,56,4,18,.222,2,12,.167,2,6,.333,.278,4,5,.800,6,10,16,1,4,0,5,4,14
346,Willy Hernangómez\hernawi01,C,27,NOP,12,0,168,42,68,.618,2,2,1.000,40,66,.606,.632,18,25,.720,31,51,82,21,6,3,12,25,104
347,Solomon Hill\hillso01,PF,30,ATL,13,1,139,3,20,.150,2,13,.154,1,7,.143,.200,0,0,,6,17,23,12,4,2,1,16,8
348,Richaun Holmes\holmeri01,C,28,SAC,21,21,586,128,181,.707,2,4,.500,126,177,.712,.713,46,57,.807,58,144,202,29,6,21,31,66,304
349,Jalen Johnson\johnsja05,PF,20,ATL,7,0,19,5,10,.500,2,4,.500,3,6,.500,.600,2,2,1.000,0,5,5,0,0,0,0,0,14
350,Georgios Kalaitzakis\kalaige01,SF,23,MIL,9,0,48,5,11,.455,2,4,.500,3,7,.429,.545,4,9,.444,4,4,8,0,1,1,4,8,16
351,Jonathan Kuminga\kuminjo01,SF,19,GSW,15,0,113,20,46,.435,2,15,.133,18,31,.581,.457,9,15,.600,8,18,26,5,5,2,8,17,51
352,Jock Landale\landajo01,C,26,SAS,8,0,24,8,10,.800,2,3,.667,6,7,.857,.900,2,3,.667,2,0,2,2,0,1,1,1,20
353,Brook Lopez\lopezbr01,C,33,MIL,1,1,28,3,9,.333,2,4,.500,1,5,.200,.444,0,0,,2,3,5,0,1,3,0,3,8
354,Wesley Matthews\matthwe02,SG,35,MIL,2,0,27,2,5,.400,2,5,.400,0,0,,.600,0,2,.000,1,2,3,0,2,1,2,3,6
355,Rodney McGruder\mcgruro01,SG,30,DET,9,0,48,5,14,.357,2,8,.250,3,6,.500,.429,2,2,1.000,2,4,6,3,0,1,1,1,14
356,Moses Moody\moodymo01,SG,19,GSW,16,0,93,11,28,.393,2,15,.133,9,13,.692,.429,1,2,.500,1,10,11,3,1,2,1,4,25
357,Matt Thomas\thomama02,SG,27,CHI,8,0,49,5,19,.263,2,9,.222,3,10,.300,.316,0,0,,0,5,5,0,2,1,0,3,12
358,Isaiah Todd\toddis01,PF,20,WAS,4,0,11,2,6,.333,2,3,.667,0,3,.000,.500,1,2,.500,1,1,2,0,2,1,1,1,7
359,Paul Watson\watsopa01,SF,27,OKC,3,0,71,2,14,.143,2,12,.167,0,2,.000,.214,1,2,.500,2,9,11,3,0,3,2,4,7
360,Jarrett Allen\allenja01,C,23,CLE,22,22,736,157,221,.710,1,4,.250,156,217,.719,.713,65,96,.677,74,173,247,39,20,28,46,38,380
361,Deandre Ayton\aytonde01,C,23,PHO,18,18,556,132,215,.614,1,5,.200,131,210,.624,.616,29,47,.617,54,145,199,27,14,13,32,42,294
362,Keita Bates-Diop\bateske01,SF,26,SAS,17,4,236,24,53,.453,1,11,.091,23,42,.548,.462,9,11,.818,12,44,56,6,7,6,12,10,58
363,Leandro Bolmaro\bolmale01,SF,21,MIN,13,1,120,8,24,.333,1,7,.143,7,17,.412,.354,6,7,.857,11,16,27,6,2,0,8,15,23
364,James Bouknight\bouknja01,SG,21,CHO,9,0,40,4,15,.267,1,3,.333,3,12,.250,.300,4,4,1.000,5,2,7,3,0,0,1,4,13
365,Willie Cauley-Stein\caulewi01,C,28,DAL,18,2,177,16,35,.457,1,2,.500,15,33,.455,.471,1,2,.500,13,25,38,9,6,3,7,17,34
366,Brandon Clarke\clarkbr01,PF,25,MEM,19,0,304,64,105,.610,1,11,.091,63,94,.670,.614,18,27,.667,33,50,83,26,7,17,8,33,147
367,DeMarcus Cousins\couside01,C,31,MIL,3,0,44,7,18,.389,1,5,.200,6,13,.462,.417,10,12,.833,4,11,15,3,3,0,3,8,25
368,Gabriel Deck\deckga01,PF,26,OKC,6,0,45,6,12,.500,1,3,.333,5,9,.556,.542,0,0,,1,4,5,3,1,0,2,2,13
369,Sekou Doumbouya\doumbse01,PF,21,LAL,2,0,16,5,8,.625,1,2,.500,4,6,.667,.688,3,4,.750,2,4,6,0,3,2,2,1,14
370,Enes Freedom\kanteen01,C,29,BOS,14,0,174,22,50,.440,1,3,.333,21,47,.447,.450,15,18,.833,30,52,82,3,3,9,9,18,60
371,Damian Jones\jonesda03,C,26,SAC,10,0,84,12,17,.706,1,2,.500,11,15,.733,.735,7,11,.636,11,14,25,5,0,3,2,12,32
372,Kevin Knox\knoxke01,SF,22,NYK,5,0,18,2,5,.400,1,3,.333,1,2,.500,.500,1,2,.500,2,0,2,1,0,0,2,2,6
373,Jake Layman\laymaja01,SF,27,MIN,7,0,34,3,10,.300,1,4,.250,2,6,.333,.350,0,0,,1,4,5,0,1,1,2,1,7
374,Boban Marjanović\marjabo01,C,33,DAL,13,0,81,29,45,.644,1,2,.500,28,43,.651,.656,6,13,.462,6,20,26,2,0,2,8,16,65
375,Skylar Mays\mayssk01,SG,24,ATL,7,0,19,4,5,.800,1,2,.500,3,3,1.000,.900,5,5,1.000,0,2,2,1,0,0,2,2,14
376,Jaylen Nowell\nowelja01,SG,22,MIN,11,0,64,12,33,.364,1,8,.125,11,25,.440,.379,2,2,1.000,3,7,10,9,3,3,1,3,27
377,David Nwaba\nwabada01,SF,29,HOU,15,0,176,23,52,.442,1,13,.077,22,39,.564,.452,14,22,.636,8,38,46,10,10,4,8,15,61
378,KZ Okpala\okpalkz01,PF,22,MIA,12,0,71,5,19,.263,1,10,.100,4,9,.444,.289,6,8,.750,5,8,13,4,1,1,0,6,17
379,Eugene Omoruyi\omorueu01,SF,24,DAL,4,0,18,2,5,.400,1,2,.500,1,3,.333,.500,2,4,.500,2,5,7,2,0,0,0,2,7
380,Kevin Pangos\pangoke01,PG,29,CLE,8,0,24,1,3,.333,1,2,.500,0,1,.000,.500,1,2,.500,1,0,1,3,1,0,3,2,4
381,Jamorko Pickett\pickeja01,PF,24,DET,3,0,9,1,1,1.000,1,1,1.000,0,0,,1.500,0,0,,0,0,0,0,0,0,1,0,3
382,Jahmi'us Ramsey\ramseja01,SG,20,SAC,7,0,46,5,14,.357,1,6,.167,4,8,.500,.393,2,4,.500,0,0,0,2,0,1,0,3,13
383,Day'Ron Sharpe\sharpda01,PF,20,BRK,8,0,36,9,17,.529,1,3,.333,8,14,.571,.559,2,5,.400,8,9,17,0,2,2,6,4,21
384,Javonte Smart\smartja01,PG,22,MIL,2,0,38,5,10,.500,1,4,.250,4,6,.667,.550,3,4,.750,3,4,7,4,0,0,2,3,14
385,Isaiah Stewart\stewais01,C,20,DET,21,21,531,70,128,.547,1,11,.091,69,117,.590,.551,16,23,.696,52,116,168,23,8,26,22,52,157
386,JT Thor\thorjt01,PF,19,CHO,4,0,35,3,8,.375,1,5,.200,2,3,.667,.438,1,2,.500,0,4,4,2,0,1,0,4,8
387,Duane Washington Jr.\washidu02,PG,21,IND,2,0,4,2,3,.667,1,2,.500,1,1,1.000,.833,0,0,,0,1,1,0,0,0,0,0,5
388,Joe Wieskamp\wieskjo01,SG,22,SAS,3,0,8,1,1,1.000,1,1,1.000,0,0,,1.500,0,0,,0,0,0,0,0,0,0,1,3
389,Justise Winslow\winslju01,SF,25,LAC,16,0,129,15,40,.375,1,8,.125,14,32,.438,.388,2,4,.500,8,27,35,17,7,5,14,11,33
390,McKinley Wright IV\wrighmc01,PG,23,MIN,1,0,4,1,1,1.000,1,1,1.000,0,0,,1.500,0,0,,0,0,0,0,0,0,1,0,3
391,Steven Adams\adamsst01,C,28,MEM,24,24,592,63,120,.525,0,0,,63,120,.525,.525,46,70,.657,91,114,205,65,20,18,36,42,172
392,Bam Adebayo\adebaba01,C,24,MIA,18,18,592,126,243,.519,0,1,.000,126,242,.521,.519,85,112,.759,49,134,183,57,20,6,53,59,337
393,Thanasis Antetokounmpo\antetth01,SF,29,MIL,20,5,257,30,62,.484,0,6,.000,30,56,.536,.484,10,17,.588,21,42,63,15,10,4,13,35,70
394,Joel Ayayi\ayayijo01,SG,21,WAS,4,0,10,0,0,,0,0,,0,0,,,0,0,,0,2,2,2,0,0,0,0,0
395,Udoka Azubuike\azubuud01,C,22,UTA,4,0,8,1,1,1.000,0,0,,1,1,1.000,1.000,0,0,,1,3,4,0,0,0,1,0,2
396,Charles Bassey\bassech01,PF,21,PHI,10,0,81,12,18,.667,0,3,.000,12,15,.800,.667,5,7,.714,10,19,29,2,1,7,3,11,29
397,Khem Birch\birchkh01,C,29,TOR,15,3,344,40,80,.500,0,6,.000,40,74,.541,.500,24,33,.727,48,37,85,20,15,7,9,27,104
398,Bol Bol\bolbo01,PF,22,DEN,10,0,47,7,15,.467,0,3,.000,7,12,.583,.467,1,3,.333,2,12,14,2,1,2,0,3,15
399,Isaac Bonga\bongais01,SF,22,TOR,8,0,35,1,6,.167,0,2,.000,1,4,.250,.167,2,4,.500,2,2,4,2,4,1,1,5,4
400,Tony Bradley\bradlto01,C,24,CHI,19,7,241,31,55,.564,0,0,,31,55,.564,.564,5,7,.714,26,54,80,8,1,11,12,25,67
401,Greg Brown III\browngr01,SF,20,POR,11,0,51,7,20,.350,0,4,.000,7,16,.438,.350,2,7,.286,5,9,14,5,2,4,2,7,16
402,Moses Brown\brownmo01,C,22,DAL,9,1,34,5,6,.833,0,0,,5,6,.833,.833,5,10,.500,2,7,9,0,1,2,4,7,15
403,Devontae Cacok\cacokde01,PF,25,SAS,1,0,2,1,1,1.000,0,0,,1,1,1.000,1.000,0,0,,1,1,2,1,0,0,0,0,2
404,Clint Capela\capelca01,C,27,ATL,25,25,747,127,223,.570,0,1,.000,127,222,.572,.570,31,61,.508,101,216,317,33,22,36,16,61,285
405,Vernon Carey Jr.\careyve01,C,20,CHO,1,0,1,0,1,.000,0,0,,0,1,.000,.000,0,0,,0,1,1,0,0,0,0,0,0
406,Justin Champagnie\champju01,SF,20,TOR,10,0,38,3,9,.333,0,1,.000,3,8,.375,.333,4,4,1.000,6,4,10,1,0,1,0,6,10
407,Nicolas Claxton\claxtni01,C,22,BRK,6,3,100,14,24,.583,0,0,,14,24,.583,.583,4,11,.364,5,26,31,4,0,4,5,12,32
408,Tyler Cook\cookty01,PF,24,CHI,1,0,12,2,3,.667,0,0,,2,3,.667,.667,2,2,1.000,0,2,2,2,0,0,1,1,6
409,Sharife Cooper\coopesh01,PG,20,ATL,5,0,11,1,4,.250,0,2,.000,1,2,.500,.250,0,0,,0,0,0,4,0,0,1,0,2
410,Petr Cornelie\cornepe01,PF,26,DEN,6,0,22,2,9,.222,0,5,.000,2,4,.500,.222,0,0,,5,4,9,3,0,0,2,4,4
411,Ed Davis\davised01,C,32,CLE,9,2,77,7,10,.700,0,0,,7,10,.700,.700,1,2,.500,4,25,29,1,2,4,3,9,15
412,Sam Dekker\dekkesa01,PF,27,TOR,1,0,1,0,0,,0,0,,0,0,,,0,0,,0,0,0,0,0,0,0,0,0
413,Devon Dotson\dotsode01,PG,22,CHI,3,0,14,1,3,.333,0,2,.000,1,1,1.000,.333,2,2,1.000,0,5,5,3,0,0,1,2,4
414,Jeff Dowtin\dowtije01,PG,24,GSW,3,0,10,2,4,.500,0,0,,2,4,.500,.500,0,0,,0,2,2,0,0,0,0,1,4
415,Andre Drummond\drumman01,C,28,PHI,23,10,483,61,126,.484,0,1,.000,61,125,.488,.484,26,49,.531,76,159,235,47,22,27,40,61,148
416,Drew Eubanks\eubandr01,C,24,SAS,22,8,318,44,87,.506,0,4,.000,44,83,.530,.506,35,44,.795,28,72,100,30,9,18,28,34,123
417,Tacko Fall\fallta01,C,26,CLE,7,0,19,1,2,.500,0,0,,1,2,.500,.500,1,4,.250,1,4,5,0,0,1,1,0,3
418,Bruno Fernando\fernabr01,C,23,BOS,8,0,18,2,3,.667,0,0,,2,3,.667,.667,0,0,,1,1,2,1,0,1,3,3,4
419,Malik Fitts\fittsma01,PF,24,UTA,3,0,7,0,0,,0,0,,0,0,,,0,0,,0,2,2,0,0,0,0,0,0
420,Trent Forrest\forretr01,PG,23,UTA,16,0,122,9,15,.600,0,2,.000,9,13,.692,.600,7,8,.875,4,14,18,10,4,0,10,9,25
421,Daniel Gafford\gaffoda01,C,23,WAS,22,22,459,86,129,.667,0,0,,86,129,.667,.667,27,39,.692,44,88,132,21,12,42,24,58,199
422,Marcus Garrett\garrema01,SG,23,MIA,4,0,10,0,1,.000,0,0,,0,1,.000,.000,0,0,,0,1,1,2,0,0,0,1,0
423,Taj Gibson\gibsota01,C,36,NYK,11,0,205,15,31,.484,0,3,.000,15,28,.536,.484,7,9,.778,21,31,52,8,4,14,11,36,37
424,Rudy Gobert\goberru01,C,29,UTA,23,23,734,122,167,.731,0,1,.000,122,166,.735,.731,98,145,.676,69,268,337,23,22,52,45,59,342
425,Josh Green\greenjo02,SG,21,DAL,12,0,61,8,15,.533,0,2,.000,8,13,.615,.533,0,2,.000,4,7,11,4,3,1,2,7,16
426,Udonis Haslem\hasleud01,C,41,MIA,5,0,23,3,6,.500,0,1,.000,3,5,.600,.500,0,0,,1,5,6,1,0,1,0,5,6
427,Sam Hauser\hausesa01,SF,24,BOS,2,0,5,0,2,.000,0,2,.000,0,0,,.000,0,0,,0,1,1,0,1,0,0,1,0
428,Aaron Henry\henryaa01,SF,22,PHI,1,0,2,0,1,.000,0,1,.000,0,0,,.000,0,0,,0,0,0,0,0,0,0,0,0
429,Jay Huff\huffja01,C,23,LAL,1,0,8,0,1,.000,0,1,.000,0,0,,.000,0,0,,1,1,2,1,0,0,0,0,0
430,Elijah Hughes\hugheel01,SF,23,UTA,6,0,17,0,2,.000,0,1,.000,0,1,.000,.000,2,2,1.000,0,1,1,0,0,0,1,2,2
431,Chandler Hutchison\hutchch01,SF,25,PHO,3,0,9,1,1,1.000,0,0,,1,1,1.000,1.000,0,0,,0,4,4,1,0,0,3,1,2
432,Isaiah Jackson\jacksis01,PF,20,IND,5,0,30,4,11,.364,0,0,,4,11,.364,.364,1,2,.500,3,6,9,0,1,1,1,9,9
433,DeJon Jarreau\jarrede01,SG,24,IND,1,0,1,0,0,,0,0,,0,0,,,0,0,,0,0,0,0,0,0,0,0,0
434,Alize Johnson\johnsal02,PF,25,CHI,14,0,104,12,21,.571,0,1,.000,12,20,.600,.571,3,5,.600,14,18,32,8,3,0,7,12,27
435,David Johnson\johnsda08,SG,20,TOR,2,0,2,0,1,.000,0,1,.000,0,0,,.000,0,0,,0,0,0,0,0,0,0,0,0
436,Keon Johnson\johnske07,SG,19,LAC,3,0,16,0,4,.000,0,1,.000,0,3,.000,.000,4,4,1.000,1,2,3,2,1,0,1,3,4
437,Kai Jones\joneska01,C,21,CHO,6,0,8,1,1,1.000,0,0,,1,1,1.000,1.000,0,0,,0,1,1,0,0,0,3,0,2
438,Tre Jones\jonestr01,PG,22,SAS,21,0,213,34,71,.479,0,5,.000,34,66,.515,.479,11,11,1.000,3,21,24,31,9,0,13,16,79
439,DeAndre Jordan\jordade01,C,33,LAL,20,16,276,45,64,.703,0,0,,45,64,.703,.703,6,10,.600,34,86,120,8,7,17,16,35,96
440,Nathan Knight\knighna01,PF,24,MIN,9,0,34,5,7,.714,0,0,,5,7,.714,.714,7,10,.700,4,6,10,3,1,2,3,5,17
441,Vit Krejci\krejcvi01,SG,21,OKC,3,0,9,0,2,.000,0,2,.000,0,0,,.000,2,2,1.000,0,3,3,0,0,0,1,0,2
442,Kevon Looney\looneke01,C,25,GSW,24,24,426,51,99,.515,0,1,.000,51,98,.520,.515,23,41,.561,59,93,152,26,12,17,16,58,125
443,Robin Lopez\lopezro01,C,33,ORL,8,1,121,22,37,.595,0,1,.000,22,36,.611,.595,10,16,.625,12,9,21,8,0,5,9,14,54
444,Didi Louzada\louzama01,SF,22,NOP,2,0,7,0,3,.000,0,3,.000,0,0,,.000,0,0,,2,0,2,1,0,0,0,0,0
445,Miles McBride\mcbrimi01,PG,21,NYK,6,0,8,1,9,.111,0,6,.000,1,3,.333,.111,0,0,,1,0,1,1,1,1,0,1,2
446,JaVale McGee\mcgeeja01,C,34,PHO,24,6,372,104,156,.667,0,0,,104,156,.667,.667,33,51,.647,57,110,167,13,8,20,39,58,241
447,JaQuori McLaughlin\mclauja01,PG,24,DAL,2,0,5,0,1,.000,0,0,,0,1,.000,.000,0,0,,0,0,0,2,0,0,0,0,0
448,RJ Nembhard\nembhrj01,SG,22,CLE,2,0,3,1,1,1.000,0,0,,1,1,1.000,1.000,0,0,,0,1,1,1,0,0,0,0,2
449,Daishen Nix\nixda01,SG,19,HOU,1,0,2,0,0,,0,0,,0,0,,,0,0,,0,0,0,1,0,0,0,0,0
450,Nerlens Noel\noelne01,C,27,NYK,11,4,261,16,31,.516,0,2,.000,16,29,.552,.516,12,13,.923,28,40,68,10,12,14,12,32,44
451,Miye Oni\onimi01,SG,24,UTA,10,0,30,1,5,.200,0,4,.000,1,1,1.000,.200,0,1,.000,0,4,4,3,0,0,1,4,2
452,Elfrid Payton\paytoel01,PG,27,PHO,10,0,117,20,43,.465,0,1,.000,20,42,.476,.465,4,8,.500,6,17,23,22,5,0,8,9,44
453,Mason Plumlee\plumlma01,C,31,CHO,20,20,523,59,99,.596,0,0,,59,99,.596,.596,18,52,.346,51,94,145,55,17,20,24,60,136
454,Jakob Poeltl\poeltja01,C,26,SAS,16,15,467,93,151,.616,0,0,,93,151,.616,.616,11,34,.324,67,82,149,38,8,26,23,46,197
455,Yves Pons\ponsyv01,SF,22,MEM,2,0,4,0,1,.000,0,0,,0,1,.000,.000,0,0,,1,0,1,0,0,0,0,0,0
456,Paul Reed\reedpa01,C,22,PHI,14,2,137,18,35,.514,0,3,.000,18,32,.563,.514,0,0,,16,22,38,8,9,9,6,21,36
457,Nick Richards\richani01,C,24,CHO,21,3,188,31,44,.705,0,0,,31,44,.705,.705,13,16,.813,21,24,45,6,4,13,12,30,75
458,Mitchell Robinson\robinmi01,C,23,NYK,21,20,531,60,80,.750,0,0,,60,80,.750,.750,28,46,.609,69,99,168,15,10,37,13,57,148
459,Wayne Selden\seldewa01,SG,27,NYK,1,0,1,0,0,,0,0,,0,0,,,0,0,,0,0,0,0,0,0,0,0,0
460,Marko Simonovic\simonma01,C,22,CHI,2,0,8,0,1,.000,0,1,.000,0,0,,.000,1,2,.500,0,1,1,0,0,0,1,0,1
461,Jericho Sims\simsje01,PF,23,NYK,8,0,54,3,3,1.000,0,0,,3,3,1.000,1.000,3,4,.750,2,12,14,0,2,3,2,4,9
462,Jalen Smith\smithja04,PF,21,PHO,7,0,36,7,14,.500,0,2,.000,7,12,.583,.500,6,7,.857,4,11,15,0,1,1,1,3,20
463,Jaden Springer\sprinja01,SG,19,PHI,1,0,2,0,0,,0,0,,0,0,,,0,0,,0,0,0,0,0,0,0,0,0
464,Brodric Thomas\thomabr01,SG,25,BOS,2,0,2,0,0,,0,0,,0,0,,,0,0,,1,0,1,0,0,0,1,0,0
465,Tristan Thompson\thomptr01,PF,30,SAC,16,0,221,36,69,.522,0,0,,36,69,.522,.522,19,34,.559,38,49,87,10,5,6,11,27,91
466,Jarred Vanderbilt\vandeja01,PF,22,MIN,23,16,530,55,102,.539,0,7,.000,55,95,.579,.539,24,29,.828,73,121,194,27,30,18,24,66,134
467,Ish Wainright\wainris01,PF,27,PHO,6,0,27,1,7,.143,0,3,.000,1,4,.250,.143,0,2,.000,3,2,5,2,2,0,2,7,2
468,Trendon Watford\watfotr01,SF,21,POR,5,0,24,5,11,.455,0,0,,5,11,.455,.455,2,3,.667,1,2,3,3,1,1,1,1,12
469,Hassan Whiteside\whiteha01,C,32,UTA,22,0,336,59,101,.584,0,0,,59,101,.584,.584,30,43,.698,44,96,140,6,5,28,22,67,148
470,Robert Williams\williro04,C,24,BOS,18,18,509,74,99,.747,0,0,,74,99,.747,.747,20,31,.645,65,86,151,21,14,33,18,29,168
471,Cassius Winston\winstca01,PG,23,WAS,1,0,4,0,1,.000,0,1,.000,0,0,,.000,2,2,1.000,0,0,0,0,0,0,1,0,2
472,Robert Woodard\woodaro01,SF,22,SAC,1,0,3,0,0,,0,0,,0,0,,,0,0,,0,0,0,0,0,0,0,0,0
473,Thaddeus Young\youngth01,PF,33,SAS,19,0,287,60,103,.583,0,3,.000,60,100,.600,.583,7,16,.438,28,39,67,49,19,6,22,27,127
474,Omer Yurtseven\yurtsom01,C,23,MIA,16,0,100,18,35,.514,0,2,.000,18,33,.545,.514,7,10,.700,6,19,25,5,1,7,5,10,43
475,Cody Zeller\zelleco01,C,29,POR,24,0,319,43,76,.566,0,4,.000,43,72,.597,.566,36,47,.766,43,67,110,20,7,6,17,50,122
476,Ivica Zubac\zubaciv01,C,24,LAC,25,25,616,92,138,.667,0,0,,92,138,.667,.667,67,88,.761,62,141,203,28,12,24,28,51,251
